,Date,Municipality,Latitude,Longitude,NewCases,Deaths,Recoveries,d_cases,n
0,2020-06-06,SAN MIGUEL,13.6403293,124.3031092,1,0,0,1,1
6,2020-07-16,SAN MIGUEL,13.6403293,124.3031092,0,0,1,-1,0
66,2020-09-10,SAN MIGUEL,13.6403293,124.3031092,1,0,0,1,1
79,2020-09-20,SAN MIGUEL,13.6403293,124.3031092,0,0,1,-1,0
89,2020-09-24,SAN MIGUEL,13.6403293,124.3031092,1,0,0,1,1
104,2020-10-11,SAN MIGUEL,13.6403293,124.3031092,0,0,1,-1,0
118,2020-10-20,SAN MIGUEL,13.6403293,124.3031092,1,0,0,1,1
140,2020-11-08,SAN MIGUEL,13.6403293,124.3031092,0,0,1,-1,0
180,2021-01-14,SAN MIGUEL,13.6403293,124.3031092,1,0,0,1,1
189,2021-01-24,SAN MIGUEL,13.6403293,124.3031092,0,0,1,-1,0
197,2021-02-01,SAN MIGUEL,13.6403293,124.3031092,1,0,0,1,1
220,2021-02-21,SAN MIGUEL,13.6403293,124.3031092,0,0,1,-1,0
292,2021-04-05,SAN MIGUEL,13.6403293,124.3031092,1,0,0,1,1
297,2021-04-08,SAN MIGUEL,13.6403293,124.3031092,1,0,0,1,2
303,2021-04-10,SAN MIGUEL,13.6403293,124.3031092,1,0,0,1,3
320,2021-04-19,SAN MIGUEL,13.6403293,124.3031092,0,0,1,-1,2
326,2021-04-22,SAN MIGUEL,13.6403293,124.3031092,0,0,1,-1,1
330,2021-04-23,SAN MIGUEL,13.6403293,124.3031092,0,0,1,-1,0
381,2021-05-09,SAN MIGUEL,13.6403293,124.3031092,1,0,0,1,1
410,2021-05-17,SAN MIGUEL,13.6403293,124.3031092,1,0,1,0,1
426,2021-05-20,SAN MIGUEL,13.6403293,124.3031092,1,0,0,1,2
440,2021-05-24,SAN MIGUEL,13.6403293,124.3031092,1,0,0,1,3
445,2021-05-25,SAN MIGUEL,13.6403293,124.3031092,4,0,0,4,7
447,2021-05-26,SAN MIGUEL,13.6403293,124.3031092,0,0,1,-1,6
466,2021-05-29,SAN MIGUEL,13.6403293,124.3031092,1,0,1,0,6
474,2021-05-31,SAN MIGUEL,13.6403293,124.3031092,1,0,0,1,7
476,2021-06-01,SAN MIGUEL,13.6403293,124.3031092,0,0,1,-1,6
483,2021-06-02,SAN MIGUEL,13.6403293,124.3031092,0,0,4,-4,2
505,2021-06-09,SAN MIGUEL,13.6403293,124.3031092,0,0,1,-1,1
512,2021-06-10,SAN MIGUEL,13.6403293,124.3031092,0,0,1,-1,0
538,2021-06-17,SAN MIGUEL,13.6403293,124.3031092,1,0,0,1,1
564,2021-06-25,SAN MIGUEL,13.6403293,124.3031092,1,0,0,1,2
574,2021-06-26,SAN MIGUEL,13.6403293,124.3031092,1,0,1,0,2
579,2021-06-27,SAN MIGUEL,13.6403293,124.3031092,1,0,0,1,3
581,2021-06-28,SAN MIGUEL,13.6403293,124.3031092,2,0,0,2,5
609,2021-07-04,SAN MIGUEL,13.6403293,124.3031092,0,0,1,-1,4
619,2021-07-05,SAN MIGUEL,13.6403293,124.3031092,3,0,0,3,7
624,2021-07-06,SAN MIGUEL,13.6403293,124.3031092,0,0,1,-1,6
631,2021-07-07,SAN MIGUEL,13.6403293,124.3031092,0,0,3,-3,3
642,2021-07-08,SAN MIGUEL,13.6403293,124.3031092,3,0,0,3,6
644,2021-07-09,SAN MIGUEL,13.6403293,124.3031092,2,0,0,2,8
652,2021-07-10,SAN MIGUEL,13.6403293,124.3031092,4,0,0,4,12
669,2021-07-12,SAN MIGUEL,13.6403293,124.3031092,1,0,0,1,13
681,2021-07-14,SAN MIGUEL,13.6403293,124.3031092,0,0,3,-3,10
692,2021-07-17,SAN MIGUEL,13.6403293,124.3031092,0,0,3,-3,7
708,2021-07-18,SAN MIGUEL,13.6403293,124.3031092,5,0,2,3,10
713,2021-07-19,SAN MIGUEL,13.6403293,124.3031092,0,0,4,-4,6
723,2021-07-21,SAN MIGUEL,13.6403293,124.3031092,0,0,1,-1,5
754,2021-07-27,SAN MIGUEL,13.6403293,124.3031092,0,0,5,-5,0
774,2021-07-31,SAN MIGUEL,13.6403293,124.3031092,1,0,0,1,1
803,2021-08-07,SAN MIGUEL,13.6403293,124.3031092,2,0,0,2,3
817,2021-08-09,SAN MIGUEL,13.6403293,124.3031092,1,0,1,0,3
845,2021-08-15,SAN MIGUEL,13.6403293,124.3031092,0,0,1,-1,2
849,2021-08-16,SAN MIGUEL,13.6403293,124.3031092,0,0,1,-1,1
860,2021-08-18,SAN MIGUEL,13.6403293,124.3031092,0,0,1,-1,0
868,2021-08-19,SAN MIGUEL,13.6403293,124.3031092,1,0,0,1,1
890,2021-08-23,SAN MIGUEL,13.6403293,124.3031092,2,0,0,2,3
912,2021-08-28,SAN MIGUEL,13.6403293,124.3031092,0,0,1,-1,2
924,2021-08-30,SAN MIGUEL,13.6403293,124.3031092,1,0,0,1,3
940,2021-09-01,SAN MIGUEL,13.6403293,124.3031092,0,0,2,-2,1
950,2021-09-03,SAN MIGUEL,13.6403293,124.3031092,2,0,0,2,3
954,2021-09-04,SAN MIGUEL,13.6403293,124.3031092,2,0,0,2,5
974,2021-09-06,SAN MIGUEL,13.6403293,124.3031092,1,0,0,1,6
988,2021-09-09,SAN MIGUEL,13.6403293,124.3031092,6,0,1,5,11
996,2021-09-11,SAN MIGUEL,13.6403293,124.3031092,1,0,0,1,12
1003,2021-09-12,SAN MIGUEL,13.6403293,124.3031092,4,0,1,3,15
1011,2021-09-13,SAN MIGUEL,13.6403293,124.3031092,0,0,2,-2,13
1028,2021-09-15,SAN MIGUEL,13.6403293,124.3031092,0,0,1,-1,12
1034,2021-09-16,SAN MIGUEL,13.6403293,124.3031092,4,0,0,4,16
1054,2021-09-18,SAN MIGUEL,13.6403293,124.3031092,3,0,7,-4,12
1075,2021-09-21,SAN MIGUEL,13.6403293,124.3031092,0,0,4,-4,8
1085,2021-09-23,SAN MIGUEL,13.6403293,124.3031092,9,0,0,9,17
1093,2021-09-24,SAN MIGUEL,13.6403293,124.3031092,3,0,0,3,20
1098,2021-09-25,SAN MIGUEL,13.6403293,124.3031092,0,0,4,-4,16
1121,2021-09-27,SAN MIGUEL,13.6403293,124.3031092,0,0,3,-3,13
1140,2021-09-30,SAN MIGUEL,13.6403293,124.3031092,2,0,0,2,15
1148,2021-10-01,SAN MIGUEL,13.6403293,124.3031092,0,0,9,-9,6
1154,2021-10-03,SAN MIGUEL,13.6403293,124.3031092,0,0,3,-3,3
1169,2021-10-06,SAN MIGUEL,13.6403293,124.3031092,1,0,0,1,4
1182,2021-10-08,SAN MIGUEL,13.6403293,124.3031092,4,0,0,4,8
1188,2021-10-09,SAN MIGUEL,13.6403293,124.3031092,0,0,2,-2,6
1204,2021-10-10,SAN MIGUEL,13.6403293,124.3031092,3,0,0,3,9
1208,2021-10-11,SAN MIGUEL,13.6403293,124.3031092,4,0,0,4,13
1222,2021-10-12,SAN MIGUEL,13.6403293,124.3031092,0,0,1,-1,12
1224,2021-10-13,SAN MIGUEL,13.6403293,124.3031092,1,0,0,1,13
1239,2021-10-15,SAN MIGUEL,13.6403293,124.3031092,5,0,1,4,17
1256,2021-10-17,SAN MIGUEL,13.6403293,124.3031092,0,0,4,-4,13
1264,2021-10-18,SAN MIGUEL,13.6403293,124.3031092,5,0,3,2,15
1278,2021-10-19,SAN MIGUEL,13.6403293,124.3031092,0,0,4,-4,11
1281,2021-10-20,SAN MIGUEL,13.6403293,124.3031092,2,0,0,2,13
1293,2021-10-21,SAN MIGUEL,13.6403293,124.3031092,2,0,0,2,15
1295,2021-10-22,SAN MIGUEL,13.6403293,124.3031092,2,0,0,2,17
1306,2021-10-23,SAN MIGUEL,13.6403293,124.3031092,0,0,1,-1,16
1316,2021-10-24,SAN MIGUEL,13.6403293,124.3031092,3,0,5,-2,14
1325,2021-10-25,SAN MIGUEL,13.6403293,124.3031092,3,0,0,3,17
1342,2021-10-27,SAN MIGUEL,13.6403293,124.3031092,0,0,5,-5,12
1348,2021-10-28,SAN MIGUEL,13.6403293,124.3031092,4,0,0,4,16
1357,2021-10-29,SAN MIGUEL,13.6403293,124.3031092,1,0,0,1,17
1363,2021-10-30,SAN MIGUEL,13.6403293,124.3031092,4,0,4,0,17
1377,2021-10-31,SAN MIGUEL,13.6403293,124.3031092,3,0,2,1,18
1385,2021-11-01,SAN MIGUEL,13.6403293,124.3031092,2,0,0,2,20
1401,2021-11-02,SAN MIGUEL,13.6403293,124.3031092,2,0,3,-1,19
1408,2021-11-03,SAN MIGUEL,13.6403293,124.3031092,0,0,3,-3,16
1420,2021-11-05,SAN MIGUEL,13.6403293,124.3031092,1,0,0,1,17
1422,2021-11-06,SAN MIGUEL,13.6403293,124.3031092,3,0,4,-1,16
1436,2021-11-08,SAN MIGUEL,13.6403293,124.3031092,1,0,5,-4,12
1450,2021-11-09,SAN MIGUEL,13.6403293,124.3031092,0,0,3,-3,9
1457,2021-11-10,SAN MIGUEL,13.6403293,124.3031092,0,0,2,-2,7
1462,2021-11-11,SAN MIGUEL,13.6403293,124.3031092,1,0,2,-1,6
1485,2021-11-13,SAN MIGUEL,13.6403293,124.3031092,1,0,0,1,7
1486,2021-11-14,SAN MIGUEL,13.6403293,124.3031092,1,0,1,0,7
1497,2021-11-15,SAN MIGUEL,13.6403293,124.3031092,0,0,3,-3,4
1519,2021-11-17,SAN MIGUEL,13.6403293,124.3031092,0,0,1,-1,3
1520,2021-11-18,SAN MIGUEL,13.6403293,124.3031092,2,0,0,2,5
1536,2021-11-20,SAN MIGUEL,13.6403293,124.3031092,0,0,1,-1,4
1560,2021-11-22,SAN MIGUEL,13.6403293,124.3031092,0,0,2,-2,2
1588,2021-11-26,SAN MIGUEL,13.6403293,124.3031092,0,0,2,-2,0
1670,2022-01-07,SAN MIGUEL,13.6403293,124.3031092,1,0,0,1,1
1682,2022-01-12,SAN MIGUEL,13.6403293,124.3031092,1,0,0,1,2
1693,2022-01-13,SAN MIGUEL,13.6403293,124.3031092,1,0,0,1,3
1695,2022-01-14,SAN MIGUEL,13.6403293,124.3031092,1,0,0,1,4
1705,2022-01-15,SAN MIGUEL,13.6403293,124.3031092,1,0,0,1,5
1717,2022-01-17,SAN MIGUEL,13.6403293,124.3031092,1,0,1,0,5
1753,2022-01-21,SAN MIGUEL,13.6403293,124.3031092,2,0,0,2,7
1754,2022-01-22,SAN MIGUEL,13.6403293,124.3031092,0,0,2,-2,5
1772,2022-01-23,SAN MIGUEL,13.6403293,124.3031092,0,0,1,-1,4
1776,2022-01-24,SAN MIGUEL,13.6403293,124.3031092,3,0,1,2,6
1791,2022-01-26,SAN MIGUEL,13.6403293,124.3031092,2,0,1,1,7
1802,2022-01-27,SAN MIGUEL,13.6403293,124.3031092,1,0,0,1,8
1822,2022-01-29,SAN MIGUEL,13.6403293,124.3031092,1,0,0,1,9
1832,2022-01-30,SAN MIGUEL,13.6403293,124.3031092,3,0,2,1,10
1850,2022-02-02,SAN MIGUEL,13.6403293,124.3031092,0,0,3,-3,7
1862,2022-02-03,SAN MIGUEL,13.6403293,124.3031092,1,0,0,1,8
1866,2022-02-04,SAN MIGUEL,13.6403293,124.3031092,3,0,0,3,11
1873,2022-02-05,SAN MIGUEL,13.6403293,124.3031092,1,0,3,-2,9
1890,2022-02-07,SAN MIGUEL,13.6403293,124.3031092,1,0,0,1,10
1898,2022-02-08,SAN MIGUEL,13.6403293,124.3031092,0,0,1,-1,9
1907,2022-02-09,SAN MIGUEL,13.6403293,124.3031092,0,0,3,-3,6
1928,2022-02-14,SAN MIGUEL,13.6403293,124.3031092,0,0,4,-4,2
1939,2022-02-16,SAN MIGUEL,13.6403293,124.3031092,0,0,1,-1,1
2064,2022-07-02,SAN MIGUEL,13.6403293,124.3031092,1,0,1,0,1
2070,2022-07-07,SAN MIGUEL,13.6403293,124.3031092,1,0,0,1,2
2072,2022-07-08,SAN MIGUEL,13.6403293,124.3031092,1,0,0,1,3
2091,2022-07-15,SAN MIGUEL,13.6403293,124.3031092,1,0,0,1,4
2094,2022-07-16,SAN MIGUEL,13.6403293,124.3031092,2,0,0,2,6
2099,2022-07-17,SAN MIGUEL,13.6403293,124.3031092,0,0,2,-2,4
2123,2022-07-24,SAN MIGUEL,13.6403293,124.3031092,2,0,0,2,6
2129,2022-07-25,SAN MIGUEL,13.6403293,124.3031092,0,0,3,-3,3
2154,2022-08-02,SAN MIGUEL,13.6403293,124.3031092,0,0,2,-2,1
2160,2022-08-03,SAN MIGUEL,13.6403293,124.3031092,1,0,0,1,2
2164,2022-08-04,SAN MIGUEL,13.6403293,124.3031092,1,0,0,1,3
2190,2022-08-11,SAN MIGUEL,13.6403293,124.3031092,0,0,1,-1,2
2197,2022-08-13,SAN MIGUEL,13.6403293,124.3031092,0,0,1,-1,1
2218,2022-08-17,SAN MIGUEL,13.6403293,124.3031092,1,0,0,1,2
2244,2022-08-23,SAN MIGUEL,13.6403293,124.3031092,0,1,0,-1,1
2253,2022-08-27,SAN MIGUEL,13.6403293,124.3031092,0,0,1,-1,0
2346,2023-04-20,SAN MIGUEL,13.6403293,124.3031092,2,0,0,2,2
2348,2023-04-28,SAN MIGUEL,13.6403293,124.3031092,1,0,2,-1,1
2350,2023-05-01,SAN MIGUEL,13.6403293,124.3031092,0,0,1,-1,0
2355,2023-05-07,SAN MIGUEL,13.6403293,124.3031092,1,0,0,1,1
2370,2023-05-14,SAN MIGUEL,13.6403293,124.3031092,4,0,0,4,5
2377,2023-05-16,SAN MIGUEL,13.6403293,124.3031092,0,0,1,-1,4
2390,2023-05-19,SAN MIGUEL,13.6403293,124.3031092,2,0,0,2,6
2394,2023-05-21,SAN MIGUEL,13.6403293,124.3031092,5,0,0,5,11
2402,2023-05-22,SAN MIGUEL,13.6403293,124.3031092,1,0,1,0,11
2406,2023-05-23,SAN MIGUEL,13.6403293,124.3031092,0,0,3,-3,8
2421,2023-05-27,SAN MIGUEL,13.6403293,124.3031092,0,0,1,-1,7
2427,2023-05-28,SAN MIGUEL,13.6403293,124.3031092,3,0,1,2,9
2437,2023-05-30,SAN MIGUEL,13.6403293,124.3031092,0,0,6,-6,3
2462,2023-06-04,SAN MIGUEL,13.6403293,124.3031092,2,0,0,2,5
2465,2023-06-05,SAN MIGUEL,13.6403293,124.3031092,0,0,2,-2,3
2471,2023-06-06,SAN MIGUEL,13.6403293,124.3031092,0,0,1,-1,2
2489,2023-06-12,SAN MIGUEL,13.6403293,124.3031092,1,0,0,1,3
2490,2023-06-13,SAN MIGUEL,13.6403293,124.3031092,0,0,2,-2,1
2506,2023-06-20,SAN MIGUEL,13.6403293,124.3031092,0,0,1,-1,0
2529,2023-08-20,SAN MIGUEL,13.6403293,124.3031092,1,0,0,1,1
2530,2023-08-26,SAN MIGUEL,13.6403293,124.3031092,1,0,0,1,2
2531,2023-08-28,SAN MIGUEL,13.6403293,124.3031092,0,0,1,-1,1
2532,2023-09-03,SAN MIGUEL,13.6403293,124.3031092,0,0,1,-1,0
1,2020-06-22,BAGAMANOC,13.9396368,124.2878298,1,0,0,1,1
10,2020-07-21,BAGAMANOC,13.9396368,124.2878298,0,0,1,-1,0
13,2020-07-25,BAGAMANOC,13.9396368,124.2878298,1,0,0,1,1
23,2020-08-09,BAGAMANOC,13.9396368,124.2878298,1,0,0,1,2
33,2020-08-16,BAGAMANOC,13.9396368,124.2878298,0,0,1,-1,1
46,2020-08-25,BAGAMANOC,13.9396368,124.2878298,0,0,1,-1,0
115,2020-10-19,BAGAMANOC,13.9396368,124.2878298,1,0,0,1,1
117,2020-10-20,BAGAMANOC,13.9396368,124.2878298,1,0,0,1,2
130,2020-11-01,BAGAMANOC,13.9396368,124.2878298,0,0,1,-1,1
137,2020-11-08,BAGAMANOC,13.9396368,124.2878298,0,0,1,-1,0
239,2021-03-04,BAGAMANOC,13.9396368,124.2878298,1,0,0,1,1
278,2021-03-28,BAGAMANOC,13.9396368,124.2878298,0,0,1,-1,0
321,2021-04-19,BAGAMANOC,13.9396368,124.2878298,1,0,0,1,1
338,2021-04-25,BAGAMANOC,13.9396368,124.2878298,4,0,0,4,5
341,2021-04-27,BAGAMANOC,13.9396368,124.2878298,2,0,0,2,7
343,2021-04-28,BAGAMANOC,13.9396368,124.2878298,0,0,1,-1,6
348,2021-04-29,BAGAMANOC,13.9396368,124.2878298,4,0,0,4,10
358,2021-05-02,BAGAMANOC,13.9396368,124.2878298,1,0,0,1,11
361,2021-05-04,BAGAMANOC,13.9396368,124.2878298,0,0,4,-4,7
365,2021-05-05,BAGAMANOC,13.9396368,124.2878298,0,0,2,-2,5
368,2021-05-06,BAGAMANOC,13.9396368,124.2878298,1,0,0,1,6
374,2021-05-08,BAGAMANOC,13.9396368,124.2878298,0,0,4,-4,2
380,2021-05-09,BAGAMANOC,13.9396368,124.2878298,2,0,0,2,4
384,2021-05-10,BAGAMANOC,13.9396368,124.2878298,0,0,1,-1,3
401,2021-05-15,BAGAMANOC,13.9396368,124.2878298,0,0,1,-1,2
413,2021-05-17,BAGAMANOC,13.9396368,124.2878298,0,0,2,-2,0
544,2021-06-19,BAGAMANOC,13.9396368,124.2878298,1,0,0,1,1
552,2021-06-21,BAGAMANOC,13.9396368,124.2878298,2,0,0,2,3
562,2021-06-24,BAGAMANOC,13.9396368,124.2878298,4,0,0,4,7
563,2021-06-25,BAGAMANOC,13.9396368,124.2878298,5,0,0,5,12
577,2021-06-27,BAGAMANOC,13.9396368,124.2878298,2,0,0,2,14
586,2021-06-28,BAGAMANOC,13.9396368,124.2878298,0,0,1,-1,13
592,2021-06-30,BAGAMANOC,13.9396368,124.2878298,0,0,2,-2,11
599,2021-07-01,BAGAMANOC,13.9396368,124.2878298,6,0,0,6,17
608,2021-07-03,BAGAMANOC,13.9396368,124.2878298,1,0,4,-3,14
614,2021-07-04,BAGAMANOC,13.9396368,124.2878298,0,0,5,-5,9
620,2021-07-05,BAGAMANOC,13.9396368,124.2878298,4,0,0,4,13
626,2021-07-06,BAGAMANOC,13.9396368,124.2878298,0,0,2,-2,11
641,2021-07-08,BAGAMANOC,13.9396368,124.2878298,4,0,0,4,15
653,2021-07-10,BAGAMANOC,13.9396368,124.2878298,0,0,6,-6,9
667,2021-07-12,BAGAMANOC,13.9396368,124.2878298,0,0,1,-1,8
677,2021-07-14,BAGAMANOC,13.9396368,124.2878298,0,0,4,-4,4
687,2021-07-16,BAGAMANOC,13.9396368,124.2878298,3,0,0,3,7
698,2021-07-17,BAGAMANOC,13.9396368,124.2878298,1,0,4,-3,4
727,2021-07-21,BAGAMANOC,13.9396368,124.2878298,1,0,0,1,5
731,2021-07-22,BAGAMANOC,13.9396368,124.2878298,3,0,0,3,8
736,2021-07-24,BAGAMANOC,13.9396368,124.2878298,1,0,0,1,9
743,2021-07-25,BAGAMANOC,13.9396368,124.2878298,3,0,3,0,9
748,2021-07-26,BAGAMANOC,13.9396368,124.2878298,4,0,0,4,13
753,2021-07-27,BAGAMANOC,13.9396368,124.2878298,0,0,1,-1,12
762,2021-07-29,BAGAMANOC,13.9396368,124.2878298,4,0,0,4,16
770,2021-07-31,BAGAMANOC,13.9396368,124.2878298,2,0,4,-2,14
782,2021-08-02,BAGAMANOC,13.9396368,124.2878298,1,0,1,0,14
787,2021-08-03,BAGAMANOC,13.9396368,124.2878298,0,0,3,-3,11
794,2021-08-04,BAGAMANOC,13.9396368,124.2878298,0,0,4,-4,7
796,2021-08-05,BAGAMANOC,13.9396368,124.2878298,4,0,0,4,11
802,2021-08-06,BAGAMANOC,13.9396368,124.2878298,4,0,0,4,15
808,2021-08-07,BAGAMANOC,13.9396368,124.2878298,1,0,4,-3,12
818,2021-08-09,BAGAMANOC,13.9396368,124.2878298,2,0,2,0,12
825,2021-08-11,BAGAMANOC,13.9396368,124.2878298,0,0,1,-1,11
829,2021-08-12,BAGAMANOC,13.9396368,124.2878298,4,0,0,4,15
840,2021-08-14,BAGAMANOC,13.9396368,124.2878298,1,0,4,-3,12
847,2021-08-15,BAGAMANOC,13.9396368,124.2878298,0,0,4,-4,8
853,2021-08-16,BAGAMANOC,13.9396368,124.2878298,0,0,1,-1,7
861,2021-08-18,BAGAMANOC,13.9396368,124.2878298,0,0,2,-2,5
870,2021-08-19,BAGAMANOC,13.9396368,124.2878298,3,0,0,3,8
881,2021-08-21,BAGAMANOC,13.9396368,124.2878298,0,0,4,-4,4
889,2021-08-23,BAGAMANOC,13.9396368,124.2878298,0,0,1,-1,3
907,2021-08-27,BAGAMANOC,13.9396368,124.2878298,1,0,0,1,4
915,2021-08-28,BAGAMANOC,13.9396368,124.2878298,0,0,2,-2,2
922,2021-08-29,BAGAMANOC,13.9396368,124.2878298,1,0,1,0,2
928,2021-08-30,BAGAMANOC,13.9396368,124.2878298,3,0,0,3,5
958,2021-09-04,BAGAMANOC,13.9396368,124.2878298,4,0,0,4,9
962,2021-09-05,BAGAMANOC,13.9396368,124.2878298,2,0,1,1,10
972,2021-09-06,BAGAMANOC,13.9396368,124.2878298,2,0,0,2,12
977,2021-09-07,BAGAMANOC,13.9396368,124.2878298,0,0,1,-1,11
983,2021-09-08,BAGAMANOC,13.9396368,124.2878298,0,0,3,-3,8
1006,2021-09-12,BAGAMANOC,13.9396368,124.2878298,1,0,0,1,9
1010,2021-09-13,BAGAMANOC,13.9396368,124.2878298,2,0,4,-2,7
1022,2021-09-14,BAGAMANOC,13.9396368,124.2878298,0,0,3,-3,4
1024,2021-09-15,BAGAMANOC,13.9396368,124.2878298,0,0,1,-1,3
1035,2021-09-16,BAGAMANOC,13.9396368,124.2878298,1,0,0,1,4
1050,2021-09-18,BAGAMANOC,13.9396368,124.2878298,1,0,0,1,5
1058,2021-09-19,BAGAMANOC,13.9396368,124.2878298,4,0,0,4,9
1069,2021-09-20,BAGAMANOC,13.9396368,124.2878298,1,0,1,0,9
1070,2021-09-21,BAGAMANOC,13.9396368,124.2878298,0,0,2,-2,7
1089,2021-09-23,BAGAMANOC,13.9396368,124.2878298,3,0,0,3,10
1090,2021-09-24,BAGAMANOC,13.9396368,124.2878298,0,0,1,-1,9
1103,2021-09-25,BAGAMANOC,13.9396368,124.2878298,0,0,1,-1,8
1113,2021-09-26,BAGAMANOC,13.9396368,124.2878298,3,0,0,3,11
1114,2021-09-27,BAGAMANOC,13.9396368,124.2878298,0,0,4,-4,7
1126,2021-09-28,BAGAMANOC,13.9396368,124.2878298,0,0,1,-1,6
1131,2021-09-29,BAGAMANOC,13.9396368,124.2878298,1,0,0,1,7
1138,2021-09-30,BAGAMANOC,13.9396368,124.2878298,1,0,3,-2,5
1145,2021-10-01,BAGAMANOC,13.9396368,124.2878298,2,0,0,2,7
1158,2021-10-03,BAGAMANOC,13.9396368,124.2878298,0,0,3,-3,4
1181,2021-10-08,BAGAMANOC,13.9396368,124.2878298,3,0,0,3,7
1186,2021-10-09,BAGAMANOC,13.9396368,124.2878298,0,0,3,-3,4
1198,2021-10-10,BAGAMANOC,13.9396368,124.2878298,5,0,1,4,8
1206,2021-10-11,BAGAMANOC,13.9396368,124.2878298,4,0,0,4,12
1238,2021-10-15,BAGAMANOC,13.9396368,124.2878298,2,0,3,-1,11
1246,2021-10-16,BAGAMANOC,13.9396368,124.2878298,5,0,0,5,16
1266,2021-10-18,BAGAMANOC,13.9396368,124.2878298,4,0,6,-2,14
1271,2021-10-19,BAGAMANOC,13.9396368,124.2878298,0,0,3,-3,11
1282,2021-10-20,BAGAMANOC,13.9396368,124.2878298,7,0,0,7,18
1298,2021-10-22,BAGAMANOC,13.9396368,124.2878298,2,0,0,2,20
1310,2021-10-23,BAGAMANOC,13.9396368,124.2878298,0,0,2,-2,18
1319,2021-10-24,BAGAMANOC,13.9396368,124.2878298,2,0,5,-3,15
1332,2021-10-25,BAGAMANOC,13.9396368,124.2878298,2,0,0,2,17
1346,2021-10-27,BAGAMANOC,13.9396368,124.2878298,0,0,4,-4,13
1347,2021-10-28,BAGAMANOC,13.9396368,124.2878298,1,0,0,1,14
1360,2021-10-29,BAGAMANOC,13.9396368,124.2878298,0,0,7,-7,7
1366,2021-10-30,BAGAMANOC,13.9396368,124.2878298,1,0,2,-1,6
1382,2021-10-31,BAGAMANOC,13.9396368,124.2878298,2,0,0,2,8
1383,2021-11-01,BAGAMANOC,13.9396368,124.2878298,0,0,1,-1,7
1398,2021-11-02,BAGAMANOC,13.9396368,124.2878298,0,0,3,-3,4
1418,2021-11-05,BAGAMANOC,13.9396368,124.2878298,0,0,1,-1,3
1428,2021-11-07,BAGAMANOC,13.9396368,124.2878298,2,0,1,1,4
1439,2021-11-08,BAGAMANOC,13.9396368,124.2878298,1,0,2,-1,3
1464,2021-11-11,BAGAMANOC,13.9396368,124.2878298,7,0,0,7,10
1482,2021-11-13,BAGAMANOC,13.9396368,124.2878298,4,0,0,4,14
1508,2021-11-16,BAGAMANOC,13.9396368,124.2878298,0,0,3,-3,11
1529,2021-11-19,BAGAMANOC,13.9396368,124.2878298,2,0,7,-5,6
1552,2021-11-21,BAGAMANOC,13.9396368,124.2878298,0,0,3,-3,3
1556,2021-11-22,BAGAMANOC,13.9396368,124.2878298,0,0,1,-1,2
1597,2021-11-27,BAGAMANOC,13.9396368,124.2878298,0,0,2,-2,0
1667,2022-01-07,BAGAMANOC,13.9396368,124.2878298,2,0,0,2,2
1704,2022-01-15,BAGAMANOC,13.9396368,124.2878298,1,0,0,1,3
1710,2022-01-16,BAGAMANOC,13.9396368,124.2878298,0,0,2,-2,1
1738,2022-01-19,BAGAMANOC,13.9396368,124.2878298,8,0,0,8,9
1740,2022-01-20,BAGAMANOC,13.9396368,124.2878298,2,0,0,2,11
1751,2022-01-21,BAGAMANOC,13.9396368,124.2878298,4,0,0,4,15
1765,2022-01-23,BAGAMANOC,13.9396368,124.2878298,0,0,1,-1,14
1778,2022-01-24,BAGAMANOC,13.9396368,124.2878298,1,0,0,1,15
1796,2022-01-26,BAGAMANOC,13.9396368,124.2878298,1,0,0,1,16
1801,2022-01-27,BAGAMANOC,13.9396368,124.2878298,2,0,0,2,18
1813,2022-01-28,BAGAMANOC,13.9396368,124.2878298,0,0,9,-9,9
1821,2022-01-29,BAGAMANOC,13.9396368,124.2878298,1,0,4,-3,6
1857,2022-02-02,BAGAMANOC,13.9396368,124.2878298,0,0,1,-1,5
1868,2022-02-04,BAGAMANOC,13.9396368,124.2878298,1,0,2,-1,4
1876,2022-02-05,BAGAMANOC,13.9396368,124.2878298,0,0,2,-2,2
1895,2022-02-07,BAGAMANOC,13.9396368,124.2878298,0,0,1,-1,1
1904,2022-02-09,BAGAMANOC,13.9396368,124.2878298,1,0,0,1,2
1947,2022-02-19,BAGAMANOC,13.9396368,124.2878298,0,0,1,-1,1
1978,2022-03-04,BAGAMANOC,13.9396368,124.2878298,1,0,0,1,2
1988,2022-03-13,BAGAMANOC,13.9396368,124.2878298,0,0,1,-1,1
2007,2022-04-15,BAGAMANOC,13.9396368,124.2878298,0,0,1,-1,0
2222,2022-08-18,BAGAMANOC,13.9396368,124.2878298,1,0,0,1,1
2260,2022-08-29,BAGAMANOC,13.9396368,124.2878298,0,1,0,-1,0
2294,2022-09-19,BAGAMANOC,13.9396368,124.2878298,1,0,0,1,1
2305,2022-09-28,BAGAMANOC,13.9396368,124.2878298,0,0,1,-1,0
2366,2023-05-12,BAGAMANOC,13.9396368,124.2878298,1,0,0,1,1
2392,2023-05-21,BAGAMANOC,13.9396368,124.2878298,0,0,1,-1,0
2431,2023-05-29,BAGAMANOC,13.9396368,124.2878298,1,0,0,1,1
2455,2023-06-03,BAGAMANOC,13.9396368,124.2878298,2,0,0,2,3
2468,2023-06-06,BAGAMANOC,13.9396368,124.2878298,0,0,1,-1,2
2484,2023-06-10,BAGAMANOC,13.9396368,124.2878298,0,0,2,-2,0
2,2020-07-06,VIRAC,13.5803594,124.2312028,1,0,0,1,1
4,2020-07-10,VIRAC,13.5803594,124.2312028,2,0,0,2,3
5,2020-07-12,VIRAC,13.5803594,124.2312028,1,0,0,1,4
7,2020-07-16,VIRAC,13.5803594,124.2312028,1,0,0,1,5
9,2020-07-19,VIRAC,13.5803594,124.2312028,1,0,0,1,6
11,2020-07-24,VIRAC,13.5803594,124.2312028,1,0,0,1,7
14,2020-07-30,VIRAC,13.5803594,124.2312028,0,0,5,-5,2
16,2020-08-03,VIRAC,13.5803594,124.2312028,1,0,0,1,3
18,2020-08-04,VIRAC,13.5803594,124.2312028,1,0,0,1,4
26,2020-08-10,VIRAC,13.5803594,124.2312028,3,0,1,2,6
29,2020-08-14,VIRAC,13.5803594,124.2312028,1,0,1,0,6
35,2020-08-16,VIRAC,13.5803594,124.2312028,3,0,1,2,8
39,2020-08-21,VIRAC,13.5803594,124.2312028,1,0,0,1,9
42,2020-08-22,VIRAC,13.5803594,124.2312028,1,0,0,1,10
44,2020-08-23,VIRAC,13.5803594,124.2312028,2,0,3,-1,9
48,2020-08-25,VIRAC,13.5803594,124.2312028,1,0,0,1,10
49,2020-08-27,VIRAC,13.5803594,124.2312028,1,0,0,1,11
50,2020-08-28,VIRAC,13.5803594,124.2312028,3,0,0,3,14
51,2020-08-29,VIRAC,13.5803594,124.2312028,1,0,0,1,15
54,2020-08-30,VIRAC,13.5803594,124.2312028,1,0,4,-3,12
56,2020-08-31,VIRAC,13.5803594,124.2312028,2,0,0,2,14
57,2020-09-04,VIRAC,13.5803594,124.2312028,1,0,0,1,15
58,2020-09-05,VIRAC,13.5803594,124.2312028,2,0,0,2,17
61,2020-09-06,VIRAC,13.5803594,124.2312028,0,0,6,-6,11
65,2020-09-08,VIRAC,13.5803594,124.2312028,3,0,0,3,14
67,2020-09-10,VIRAC,13.5803594,124.2312028,2,0,0,2,16
70,2020-09-12,VIRAC,13.5803594,124.2312028,2,0,0,2,18
71,2020-09-13,VIRAC,13.5803594,124.2312028,1,0,4,-3,15
75,2020-09-14,VIRAC,13.5803594,124.2312028,0,1,0,-1,14
76,2020-09-15,VIRAC,13.5803594,124.2312028,1,0,0,1,15
78,2020-09-18,VIRAC,13.5803594,124.2312028,1,0,0,1,16
80,2020-09-20,VIRAC,13.5803594,124.2312028,0,0,4,-4,12
85,2020-09-22,VIRAC,13.5803594,124.2312028,4,0,0,4,16
87,2020-09-23,VIRAC,13.5803594,124.2312028,1,0,0,1,17
88,2020-09-24,VIRAC,13.5803594,124.2312028,4,0,0,4,21
94,2020-09-27,VIRAC,13.5803594,124.2312028,2,0,8,-6,15
96,2020-10-02,VIRAC,13.5803594,124.2312028,0,1,0,-1,14
99,2020-10-04,VIRAC,13.5803594,124.2312028,1,0,7,-6,8
101,2020-10-06,VIRAC,13.5803594,124.2312028,2,0,0,2,10
103,2020-10-09,VIRAC,13.5803594,124.2312028,1,0,1,0,10
107,2020-10-11,VIRAC,13.5803594,124.2312028,1,0,4,-3,7
108,2020-10-13,VIRAC,13.5803594,124.2312028,2,0,0,2,9
109,2020-10-15,VIRAC,13.5803594,124.2312028,0,0,2,-2,7
110,2020-10-16,VIRAC,13.5803594,124.2312028,1,0,1,0,7
120,2020-10-23,VIRAC,13.5803594,124.2312028,1,0,0,1,8
122,2020-10-25,VIRAC,13.5803594,124.2312028,1,0,4,-3,5
126,2020-10-28,VIRAC,13.5803594,124.2312028,1,0,0,1,6
129,2020-11-01,VIRAC,13.5803594,124.2312028,0,0,3,-3,3
134,2020-11-03,VIRAC,13.5803594,124.2312028,1,0,0,1,4
138,2020-11-08,VIRAC,13.5803594,124.2312028,0,0,2,-2,2
143,2020-11-15,VIRAC,13.5803594,124.2312028,0,0,1,-1,1
144,2020-11-16,VIRAC,13.5803594,124.2312028,1,0,0,1,2
146,2020-11-21,VIRAC,13.5803594,124.2312028,2,0,0,2,4
147,2020-11-22,VIRAC,13.5803594,124.2312028,0,0,1,-1,3
149,2020-11-24,VIRAC,13.5803594,124.2312028,2,0,0,2,5
150,2020-11-29,VIRAC,13.5803594,124.2312028,0,0,1,-1,4
152,2020-12-06,VIRAC,13.5803594,124.2312028,1,0,2,-1,3
154,2020-12-13,VIRAC,13.5803594,124.2312028,0,0,2,-2,1
157,2020-12-15,VIRAC,13.5803594,124.2312028,2,0,0,2,3
158,2020-12-17,VIRAC,13.5803594,124.2312028,2,0,0,2,5
159,2020-12-19,VIRAC,13.5803594,124.2312028,1,0,0,1,6
160,2020-12-20,VIRAC,13.5803594,124.2312028,0,0,1,-1,5
163,2020-12-22,VIRAC,13.5803594,124.2312028,3,0,0,3,8
164,2020-12-23,VIRAC,13.5803594,124.2312028,1,0,0,1,9
170,2021-01-03,VIRAC,13.5803594,124.2312028,0,0,5,-5,4
175,2021-01-10,VIRAC,13.5803594,124.2312028,0,0,4,-4,0
176,2021-01-13,VIRAC,13.5803594,124.2312028,2,0,0,2,2
179,2021-01-14,VIRAC,13.5803594,124.2312028,6,0,0,6,8
182,2021-01-15,VIRAC,13.5803594,124.2312028,1,0,0,1,9
184,2021-01-17,VIRAC,13.5803594,124.2312028,2,0,0,2,11
187,2021-01-24,VIRAC,13.5803594,124.2312028,2,0,5,-3,8
190,2021-01-26,VIRAC,13.5803594,124.2312028,3,0,0,3,11
191,2021-01-28,VIRAC,13.5803594,124.2312028,1,1,0,0,11
195,2021-01-31,VIRAC,13.5803594,124.2312028,5,0,5,0,11
198,2021-02-02,VIRAC,13.5803594,124.2312028,1,0,0,1,12
200,2021-02-05,VIRAC,13.5803594,124.2312028,1,0,0,1,13
204,2021-02-07,VIRAC,13.5803594,124.2312028,0,0,2,-2,11
205,2021-02-09,VIRAC,13.5803594,124.2312028,1,0,0,1,12
206,2021-02-13,VIRAC,13.5803594,124.2312028,1,0,0,1,13
207,2021-02-14,VIRAC,13.5803594,124.2312028,3,0,9,-6,7
214,2021-02-17,VIRAC,13.5803594,124.2312028,1,0,0,1,8
216,2021-02-18,VIRAC,13.5803594,124.2312028,1,0,0,1,9
217,2021-02-19,VIRAC,13.5803594,124.2312028,2,0,0,2,11
219,2021-02-21,VIRAC,13.5803594,124.2312028,0,0,2,-2,9
224,2021-02-22,VIRAC,13.5803594,124.2312028,2,0,0,2,11
226,2021-02-25,VIRAC,13.5803594,124.2312028,1,0,0,1,12
227,2021-02-26,VIRAC,13.5803594,124.2312028,1,0,0,1,13
229,2021-02-27,VIRAC,13.5803594,124.2312028,1,0,0,1,14
231,2021-02-28,VIRAC,13.5803594,124.2312028,0,0,4,-4,10
236,2021-03-01,VIRAC,13.5803594,124.2312028,3,0,0,3,13
243,2021-03-06,VIRAC,13.5803594,124.2312028,3,0,0,3,16
244,2021-03-07,VIRAC,13.5803594,124.2312028,0,0,3,-3,13
249,2021-03-08,VIRAC,13.5803594,124.2312028,2,0,0,2,15
253,2021-03-10,VIRAC,13.5803594,124.2312028,2,0,0,2,17
256,2021-03-13,VIRAC,13.5803594,124.2312028,1,0,0,1,18
258,2021-03-14,VIRAC,13.5803594,124.2312028,0,0,5,-5,13
259,2021-03-15,VIRAC,13.5803594,124.2312028,1,0,0,1,14
261,2021-03-19,VIRAC,13.5803594,124.2312028,1,0,0,1,15
264,2021-03-21,VIRAC,13.5803594,124.2312028,0,0,5,-5,10
267,2021-03-22,VIRAC,13.5803594,124.2312028,2,0,0,2,12
273,2021-03-27,VIRAC,13.5803594,124.2312028,0,0,1,-1,11
274,2021-03-28,VIRAC,13.5803594,124.2312028,0,0,5,-5,6
279,2021-03-29,VIRAC,13.5803594,124.2312028,2,0,0,2,8
282,2021-03-30,VIRAC,13.5803594,124.2312028,1,0,0,1,9
283,2021-04-01,VIRAC,13.5803594,124.2312028,2,0,0,2,11
287,2021-04-03,VIRAC,13.5803594,124.2312028,4,0,0,4,15
291,2021-04-04,VIRAC,13.5803594,124.2312028,1,0,2,-1,14
293,2021-04-07,VIRAC,13.5803594,124.2312028,1,0,0,1,15
296,2021-04-08,VIRAC,13.5803594,124.2312028,1,0,0,1,16
304,2021-04-11,VIRAC,13.5803594,124.2312028,1,0,2,-1,15
310,2021-04-15,VIRAC,13.5803594,124.2312028,1,0,0,1,16
317,2021-04-18,VIRAC,13.5803594,124.2312028,0,0,9,-9,7
322,2021-04-19,VIRAC,13.5803594,124.2312028,1,0,1,0,7
325,2021-04-21,VIRAC,13.5803594,124.2312028,0,0,2,-2,5
332,2021-04-23,VIRAC,13.5803594,124.2312028,1,0,1,0,5
337,2021-04-25,VIRAC,13.5803594,124.2312028,0,0,1,-1,4
342,2021-04-27,VIRAC,13.5803594,124.2312028,2,0,0,2,6
344,2021-04-28,VIRAC,13.5803594,124.2312028,0,0,1,-1,5
350,2021-04-29,VIRAC,13.5803594,124.2312028,1,0,0,1,6
355,2021-05-02,VIRAC,13.5803594,124.2312028,0,0,1,-1,5
362,2021-05-04,VIRAC,13.5803594,124.2312028,2,0,0,2,7
369,2021-05-06,VIRAC,13.5803594,124.2312028,0,0,1,-1,6
372,2021-05-07,VIRAC,13.5803594,124.2312028,1,0,0,1,7
376,2021-05-08,VIRAC,13.5803594,124.2312028,1,0,1,0,7
389,2021-05-11,VIRAC,13.5803594,124.2312028,4,0,0,4,11
390,2021-05-12,VIRAC,13.5803594,124.2312028,0,0,2,-2,9
396,2021-05-13,VIRAC,13.5803594,124.2312028,3,0,0,3,12
403,2021-05-15,VIRAC,13.5803594,124.2312028,2,0,1,1,13
407,2021-05-16,VIRAC,13.5803594,124.2312028,2,0,0,2,15
412,2021-05-17,VIRAC,13.5803594,124.2312028,1,0,1,0,15
417,2021-05-18,VIRAC,13.5803594,124.2312028,2,0,0,2,17
420,2021-05-19,VIRAC,13.5803594,124.2312028,0,0,4,-4,13
424,2021-05-20,VIRAC,13.5803594,124.2312028,3,0,0,3,16
428,2021-05-21,VIRAC,13.5803594,124.2312028,4,0,0,4,20
431,2021-05-22,VIRAC,13.5803594,124.2312028,1,1,3,-3,17
439,2021-05-24,VIRAC,13.5803594,124.2312028,2,0,4,-2,15
441,2021-05-25,VIRAC,13.5803594,124.2312028,6,0,0,6,21
453,2021-05-26,VIRAC,13.5803594,124.2312028,3,0,2,1,22
455,2021-05-27,VIRAC,13.5803594,124.2312028,5,0,0,5,27
459,2021-05-28,VIRAC,13.5803594,124.2312028,2,0,3,-1,26
465,2021-05-29,VIRAC,13.5803594,124.2312028,4,0,4,0,26
467,2021-05-30,VIRAC,13.5803594,124.2312028,1,0,0,1,27
475,2021-05-31,VIRAC,13.5803594,124.2312028,4,1,4,-1,26
479,2021-06-01,VIRAC,13.5803594,124.2312028,0,0,3,-3,23
480,2021-06-02,VIRAC,13.5803594,124.2312028,0,0,6,-6,17
488,2021-06-03,VIRAC,13.5803594,124.2312028,3,0,1,2,19
491,2021-06-04,VIRAC,13.5803594,124.2312028,4,0,0,4,23
494,2021-06-05,VIRAC,13.5803594,124.2312028,0,0,5,-5,18
495,2021-06-06,VIRAC,13.5803594,124.2312028,0,0,2,-2,16
501,2021-06-07,VIRAC,13.5803594,124.2312028,8,0,3,5,21
511,2021-06-09,VIRAC,13.5803594,124.2312028,7,0,4,3,24
513,2021-06-10,VIRAC,13.5803594,124.2312028,2,0,1,1,25
517,2021-06-12,VIRAC,13.5803594,124.2312028,1,0,6,-5,20
522,2021-06-13,VIRAC,13.5803594,124.2312028,4,0,0,4,24
528,2021-06-15,VIRAC,13.5803594,124.2312028,2,0,8,-6,18
533,2021-06-16,VIRAC,13.5803594,124.2312028,0,0,9,-9,9
540,2021-06-17,VIRAC,13.5803594,124.2312028,9,0,0,9,18
543,2021-06-19,VIRAC,13.5803594,124.2312028,3,0,1,2,20
549,2021-06-21,VIRAC,13.5803594,124.2312028,11,0,3,8,28
555,2021-06-23,VIRAC,13.5803594,124.2312028,0,0,2,-2,26
559,2021-06-24,VIRAC,13.5803594,124.2312028,15,0,0,15,41
565,2021-06-25,VIRAC,13.5803594,124.2312028,5,0,0,5,46
572,2021-06-26,VIRAC,13.5803594,124.2312028,3,0,7,-4,42
578,2021-06-27,VIRAC,13.5803594,124.2312028,1,0,1,0,42
585,2021-06-28,VIRAC,13.5803594,124.2312028,4,0,2,2,44
590,2021-06-30,VIRAC,13.5803594,124.2312028,0,0,10,-10,34
596,2021-07-01,VIRAC,13.5803594,124.2312028,9,1,0,8,42
601,2021-07-02,VIRAC,13.5803594,124.2312028,3,0,0,3,45
605,2021-07-03,VIRAC,13.5803594,124.2312028,2,0,15,-13,32
611,2021-07-04,VIRAC,13.5803594,124.2312028,2,0,5,-3,29
618,2021-07-05,VIRAC,13.5803594,124.2312028,7,0,3,4,33
625,2021-07-06,VIRAC,13.5803594,124.2312028,0,0,1,-1,32
630,2021-07-07,VIRAC,13.5803594,124.2312028,0,0,4,-4,28
635,2021-07-08,VIRAC,13.5803594,124.2312028,15,0,0,15,43
659,2021-07-10,VIRAC,13.5803594,124.2312028,1,0,9,-8,35
661,2021-07-11,VIRAC,13.5803594,124.2312028,0,0,2,-2,33
668,2021-07-12,VIRAC,13.5803594,124.2312028,3,0,2,1,34
673,2021-07-13,VIRAC,13.5803594,124.2312028,0,0,2,-2,32
676,2021-07-14,VIRAC,13.5803594,124.2312028,0,0,7,-7,25
684,2021-07-15,VIRAC,13.5803594,124.2312028,1,0,0,1,26
689,2021-07-16,VIRAC,13.5803594,124.2312028,1,0,0,1,27
697,2021-07-17,VIRAC,13.5803594,124.2312028,1,0,14,-13,14
709,2021-07-18,VIRAC,13.5803594,124.2312028,2,0,1,1,15
710,2021-07-19,VIRAC,13.5803594,124.2312028,0,0,1,-1,14
716,2021-07-20,VIRAC,13.5803594,124.2312028,0,0,2,-2,12
722,2021-07-21,VIRAC,13.5803594,124.2312028,0,0,2,-2,10
728,2021-07-22,VIRAC,13.5803594,124.2312028,13,0,1,12,22
734,2021-07-23,VIRAC,13.5803594,124.2312028,3,0,0,3,25
737,2021-07-24,VIRAC,13.5803594,124.2312028,2,0,1,1,26
742,2021-07-25,VIRAC,13.5803594,124.2312028,3,0,0,3,29
749,2021-07-26,VIRAC,13.5803594,124.2312028,3,0,1,2,31
755,2021-07-27,VIRAC,13.5803594,124.2312028,0,0,3,-3,28
761,2021-07-29,VIRAC,13.5803594,124.2312028,6,0,0,6,34
768,2021-07-30,VIRAC,13.5803594,124.2312028,0,1,1,-2,32
769,2021-07-31,VIRAC,13.5803594,124.2312028,2,0,13,-11,21
778,2021-08-01,VIRAC,13.5803594,124.2312028,2,0,1,1,22
779,2021-08-02,VIRAC,13.5803594,124.2312028,1,0,3,-2,20
786,2021-08-03,VIRAC,13.5803594,124.2312028,0,0,2,-2,18
791,2021-08-04,VIRAC,13.5803594,124.2312028,0,0,3,-3,15
798,2021-08-05,VIRAC,13.5803594,124.2312028,10,0,0,10,25
800,2021-08-06,VIRAC,13.5803594,124.2312028,4,0,0,4,29
809,2021-08-07,VIRAC,13.5803594,124.2312028,1,0,6,-5,24
819,2021-08-09,VIRAC,13.5803594,124.2312028,9,0,2,7,31
822,2021-08-10,VIRAC,13.5803594,124.2312028,1,0,2,-1,30
826,2021-08-11,VIRAC,13.5803594,124.2312028,0,0,1,-1,29
830,2021-08-12,VIRAC,13.5803594,124.2312028,2,0,0,2,31
834,2021-08-13,VIRAC,13.5803594,124.2312028,1,0,1,0,31
835,2021-08-14,VIRAC,13.5803594,124.2312028,5,0,11,-6,25
843,2021-08-15,VIRAC,13.5803594,124.2312028,1,0,1,0,25
848,2021-08-16,VIRAC,13.5803594,124.2312028,2,0,1,1,26
856,2021-08-17,VIRAC,13.5803594,124.2312028,1,0,0,1,27
863,2021-08-18,VIRAC,13.5803594,124.2312028,1,0,10,-9,18
873,2021-08-19,VIRAC,13.5803594,124.2312028,2,0,0,2,20
875,2021-08-20,VIRAC,13.5803594,124.2312028,4,0,0,4,24
877,2021-08-21,VIRAC,13.5803594,124.2312028,1,0,2,-1,23
884,2021-08-22,VIRAC,13.5803594,124.2312028,6,0,2,4,27
893,2021-08-23,VIRAC,13.5803594,124.2312028,1,0,5,-4,23
898,2021-08-24,VIRAC,13.5803594,124.2312028,0,0,1,-1,22
900,2021-08-25,VIRAC,13.5803594,124.2312028,0,0,2,-2,20
904,2021-08-26,VIRAC,13.5803594,124.2312028,7,0,0,7,27
908,2021-08-27,VIRAC,13.5803594,124.2312028,5,0,2,3,30
916,2021-08-28,VIRAC,13.5803594,124.2312028,7,0,2,5,35
920,2021-08-29,VIRAC,13.5803594,124.2312028,5,0,3,2,37
927,2021-08-30,VIRAC,13.5803594,124.2312028,5,0,4,1,38
930,2021-08-31,VIRAC,13.5803594,124.2312028,2,0,4,-2,36
938,2021-09-01,VIRAC,13.5803594,124.2312028,1,0,1,0,36
949,2021-09-03,VIRAC,13.5803594,124.2312028,10,0,0,10,46
952,2021-09-04,VIRAC,13.5803594,124.2312028,7,0,6,1,47
963,2021-09-05,VIRAC,13.5803594,124.2312028,7,0,6,1,48
971,2021-09-06,VIRAC,13.5803594,124.2312028,8,0,7,1,49
979,2021-09-07,VIRAC,13.5803594,124.2312028,0,0,5,-5,44
981,2021-09-08,VIRAC,13.5803594,124.2312028,0,0,6,-6,38
986,2021-09-09,VIRAC,13.5803594,124.2312028,11,0,1,10,48
998,2021-09-11,VIRAC,13.5803594,124.2312028,3,0,1,2,50
1008,2021-09-12,VIRAC,13.5803594,124.2312028,9,0,10,-1,49
1013,2021-09-13,VIRAC,13.5803594,124.2312028,9,0,7,2,51
1020,2021-09-14,VIRAC,13.5803594,124.2312028,1,0,5,-4,47
1030,2021-09-15,VIRAC,13.5803594,124.2312028,0,0,9,-9,38
1037,2021-09-16,VIRAC,13.5803594,124.2312028,7,0,0,7,45
1045,2021-09-17,VIRAC,13.5803594,124.2312028,3,0,1,2,47
1056,2021-09-18,VIRAC,13.5803594,124.2312028,5,0,13,-8,39
1060,2021-09-19,VIRAC,13.5803594,124.2312028,11,0,1,10,49
1064,2021-09-20,VIRAC,13.5803594,124.2312028,3,0,1,2,51
1071,2021-09-21,VIRAC,13.5803594,124.2312028,0,0,8,-8,43
1079,2021-09-22,VIRAC,13.5803594,124.2312028,0,0,9,-9,34
1083,2021-09-23,VIRAC,13.5803594,124.2312028,18,1,1,16,50
1091,2021-09-24,VIRAC,13.5803594,124.2312028,9,0,0,9,59
1101,2021-09-25,VIRAC,13.5803594,124.2312028,2,0,7,-5,54
1107,2021-09-26,VIRAC,13.5803594,124.2312028,2,0,2,0,54
1118,2021-09-27,VIRAC,13.5803594,124.2312028,11,0,5,6,60
1124,2021-09-28,VIRAC,13.5803594,124.2312028,0,1,13,-14,46
1136,2021-09-30,VIRAC,13.5803594,124.2312028,19,0,0,19,65
1146,2021-10-01,VIRAC,13.5803594,124.2312028,22,0,19,3,68
1150,2021-10-02,VIRAC,13.5803594,124.2312028,8,0,0,8,76
1161,2021-10-03,VIRAC,13.5803594,124.2312028,2,0,19,-17,59
1162,2021-10-04,VIRAC,13.5803594,124.2312028,0,0,2,-2,57
1164,2021-10-05,VIRAC,13.5803594,124.2312028,8,0,0,8,65
1173,2021-10-06,VIRAC,13.5803594,124.2312028,14,0,0,14,79
1177,2021-10-07,VIRAC,13.5803594,124.2312028,1,0,1,0,79
1184,2021-10-08,VIRAC,13.5803594,124.2312028,14,0,0,14,93
1191,2021-10-09,VIRAC,13.5803594,124.2312028,21,0,26,-5,88
1202,2021-10-10,VIRAC,13.5803594,124.2312028,11,0,23,-12,76
1211,2021-10-11,VIRAC,13.5803594,124.2312028,20,0,0,20,96
1219,2021-10-12,VIRAC,13.5803594,124.2312028,3,0,15,-12,84
1226,2021-10-13,VIRAC,13.5803594,124.2312028,20,1,0,19,103
1230,2021-10-14,VIRAC,13.5803594,124.2312028,1,0,0,1,104
1235,2021-10-15,VIRAC,13.5803594,124.2312028,8,0,12,-4,100
1247,2021-10-16,VIRAC,13.5803594,124.2312028,12,0,0,12,112
1255,2021-10-17,VIRAC,13.5803594,124.2312028,5,0,18,-13,99
1262,2021-10-18,VIRAC,13.5803594,124.2312028,25,0,21,4,103
1274,2021-10-19,VIRAC,13.5803594,124.2312028,1,0,22,-21,82
1286,2021-10-20,VIRAC,13.5803594,124.2312028,4,0,0,4,86
1292,2021-10-21,VIRAC,13.5803594,124.2312028,1,0,1,0,86
1302,2021-10-22,VIRAC,13.5803594,124.2312028,8,0,0,8,94
1308,2021-10-23,VIRAC,13.5803594,124.2312028,23,0,21,2,96
1318,2021-10-24,VIRAC,13.5803594,124.2312028,3,0,8,-5,91
1323,2021-10-25,VIRAC,13.5803594,124.2312028,11,0,11,0,91
1339,2021-10-26,VIRAC,13.5803594,124.2312028,0,0,7,-7,84
1341,2021-10-27,VIRAC,13.5803594,124.2312028,0,0,22,-22,62
1351,2021-10-28,VIRAC,13.5803594,124.2312028,21,0,0,21,83
1356,2021-10-29,VIRAC,13.5803594,124.2312028,1,0,1,0,83
1371,2021-10-30,VIRAC,13.5803594,124.2312028,16,0,6,10,93
1380,2021-10-31,VIRAC,13.5803594,124.2312028,8,0,9,-1,92
1384,2021-11-01,VIRAC,13.5803594,124.2312028,9,0,22,-13,79
1400,2021-11-02,VIRAC,13.5803594,124.2312028,2,0,6,-4,75
1406,2021-11-03,VIRAC,13.5803594,124.2312028,0,1,8,-9,66
1416,2021-11-05,VIRAC,13.5803594,124.2312028,16,1,0,15,81
1426,2021-11-06,VIRAC,13.5803594,124.2312028,4,0,19,-15,66
1429,2021-11-07,VIRAC,13.5803594,124.2312028,9,0,1,8,74
1440,2021-11-08,VIRAC,13.5803594,124.2312028,13,0,18,-5,69
1449,2021-11-09,VIRAC,13.5803594,124.2312028,0,0,6,-6,63
1459,2021-11-10,VIRAC,13.5803594,124.2312028,0,0,11,-11,52
1468,2021-11-11,VIRAC,13.5803594,124.2312028,9,0,2,7,59
1475,2021-11-12,VIRAC,13.5803594,124.2312028,6,0,1,5,64
1484,2021-11-13,VIRAC,13.5803594,124.2312028,3,0,0,3,67
1494,2021-11-14,VIRAC,13.5803594,124.2312028,6,0,15,-9,58
1502,2021-11-15,VIRAC,13.5803594,124.2312028,12,1,3,8,66
1507,2021-11-16,VIRAC,13.5803594,124.2312028,0,0,10,-10,56
1518,2021-11-17,VIRAC,13.5803594,124.2312028,0,0,12,-12,44
1521,2021-11-18,VIRAC,13.5803594,124.2312028,9,0,0,9,53
1535,2021-11-19,VIRAC,13.5803594,124.2312028,8,0,0,8,61
1540,2021-11-20,VIRAC,13.5803594,124.2312028,7,0,8,-1,60
1546,2021-11-21,VIRAC,13.5803594,124.2312028,2,0,7,-5,55
1559,2021-11-22,VIRAC,13.5803594,124.2312028,1,0,3,-2,53
1565,2021-11-23,VIRAC,13.5803594,124.2312028,0,0,5,-5,48
1574,2021-11-24,VIRAC,13.5803594,124.2312028,0,0,12,-12,36
1576,2021-11-25,VIRAC,13.5803594,124.2312028,5,0,0,5,41
1586,2021-11-26,VIRAC,13.5803594,124.2312028,0,1,0,-1,40
1595,2021-11-27,VIRAC,13.5803594,124.2312028,0,0,9,-9,31
1604,2021-11-28,VIRAC,13.5803594,124.2312028,2,0,9,-7,24
1606,2021-11-29,VIRAC,13.5803594,124.2312028,0,0,4,-4,20
1613,2021-11-30,VIRAC,13.5803594,124.2312028,0,0,1,-1,19
1614,2021-12-01,VIRAC,13.5803594,124.2312028,1,0,1,0,19
1621,2021-12-04,VIRAC,13.5803594,124.2312028,0,1,3,-4,15
1623,2021-12-05,VIRAC,13.5803594,124.2312028,0,0,1,-1,14
1626,2021-12-06,VIRAC,13.5803594,124.2312028,1,0,0,1,15
1631,2021-12-08,VIRAC,13.5803594,124.2312028,3,0,1,2,17
1636,2021-12-10,VIRAC,13.5803594,124.2312028,0,0,1,-1,16
1637,2021-12-11,VIRAC,13.5803594,124.2312028,0,0,1,-1,15
1642,2021-12-15,VIRAC,13.5803594,124.2312028,0,0,1,-1,14
1645,2021-12-18,VIRAC,13.5803594,124.2312028,0,0,3,-3,11
1653,2021-12-27,VIRAC,13.5803594,124.2312028,0,1,0,-1,10
1655,2021-12-31,VIRAC,13.5803594,124.2312028,1,0,0,1,11
1656,2022-01-01,VIRAC,13.5803594,124.2312028,0,0,1,-1,10
1659,2022-01-03,VIRAC,13.5803594,124.2312028,0,0,1,-1,9
1661,2022-01-05,VIRAC,13.5803594,124.2312028,1,0,0,1,10
1662,2022-01-06,VIRAC,13.5803594,124.2312028,2,0,0,2,12
1669,2022-01-07,VIRAC,13.5803594,124.2312028,1,0,1,0,12
1674,2022-01-09,VIRAC,13.5803594,124.2312028,2,0,0,2,14
1679,2022-01-10,VIRAC,13.5803594,124.2312028,6,0,0,6,20
1681,2022-01-11,VIRAC,13.5803594,124.2312028,1,0,0,1,21
1684,2022-01-12,VIRAC,13.5803594,124.2312028,0,0,1,-1,20
1690,2022-01-13,VIRAC,13.5803594,124.2312028,17,0,0,17,37
1697,2022-01-14,VIRAC,13.5803594,124.2312028,5,0,0,5,42
1706,2022-01-15,VIRAC,13.5803594,124.2312028,7,0,2,5,47
1708,2022-01-16,VIRAC,13.5803594,124.2312028,8,0,0,8,55
1722,2022-01-17,VIRAC,13.5803594,124.2312028,7,0,1,6,61
1727,2022-01-18,VIRAC,13.5803594,124.2312028,1,0,1,0,61
1734,2022-01-19,VIRAC,13.5803594,124.2312028,16,0,5,11,72
1742,2022-01-20,VIRAC,13.5803594,124.2312028,1,0,7,-6,66
1747,2022-01-21,VIRAC,13.5803594,124.2312028,3,0,0,3,69
1761,2022-01-22,VIRAC,13.5803594,124.2312028,8,0,14,-6,63
1764,2022-01-23,VIRAC,13.5803594,124.2312028,4,0,6,-2,61
1780,2022-01-24,VIRAC,13.5803594,124.2312028,2,0,4,-2,59
1784,2022-01-25,VIRAC,13.5803594,124.2312028,5,0,7,-2,57
1794,2022-01-26,VIRAC,13.5803594,124.2312028,11,0,5,6,63
1805,2022-01-27,VIRAC,13.5803594,124.2312028,24,0,4,20,83
1811,2022-01-28,VIRAC,13.5803594,124.2312028,4,0,1,3,86
1824,2022-01-29,VIRAC,13.5803594,124.2312028,5,0,15,-10,76
1829,2022-01-30,VIRAC,13.5803594,124.2312028,4,0,5,-1,75
1840,2022-01-31,VIRAC,13.5803594,124.2312028,1,0,5,-4,71
1847,2022-02-01,VIRAC,13.5803594,124.2312028,2,0,7,-5,66
1854,2022-02-02,VIRAC,13.5803594,124.2312028,4,0,5,-1,65
1860,2022-02-03,VIRAC,13.5803594,124.2312028,0,0,2,-2,63
1871,2022-02-04,VIRAC,13.5803594,124.2312028,5,0,0,5,68
1881,2022-02-05,VIRAC,13.5803594,124.2312028,1,0,23,-22,46
1884,2022-02-06,VIRAC,13.5803594,124.2312028,5,0,16,-11,35
1892,2022-02-07,VIRAC,13.5803594,124.2312028,3,0,0,3,38
1901,2022-02-08,VIRAC,13.5803594,124.2312028,0,0,6,-6,32
1911,2022-02-09,VIRAC,13.5803594,124.2312028,2,0,3,-1,31
1913,2022-02-10,VIRAC,13.5803594,124.2312028,1,0,1,0,31
1921,2022-02-12,VIRAC,13.5803594,124.2312028,2,0,5,-3,28
1926,2022-02-13,VIRAC,13.5803594,124.2312028,1,0,1,0,28
1929,2022-02-14,VIRAC,13.5803594,124.2312028,0,0,3,-3,25
1934,2022-02-15,VIRAC,13.5803594,124.2312028,0,0,2,-2,23
1938,2022-02-16,VIRAC,13.5803594,124.2312028,2,0,8,-6,17
1946,2022-02-18,VIRAC,13.5803594,124.2312028,2,0,0,2,19
1948,2022-02-19,VIRAC,13.5803594,124.2312028,1,0,2,-1,18
1953,2022-02-20,VIRAC,13.5803594,124.2312028,3,0,1,2,20
1956,2022-02-22,VIRAC,13.5803594,124.2312028,0,0,2,-2,18
1959,2022-02-23,VIRAC,13.5803594,124.2312028,2,0,1,1,19
1961,2022-02-24,VIRAC,13.5803594,124.2312028,2,0,0,2,21
1969,2022-02-26,VIRAC,13.5803594,124.2312028,0,0,2,-2,19
1970,2022-02-27,VIRAC,13.5803594,124.2312028,1,0,0,1,20
1972,2022-02-28,VIRAC,13.5803594,124.2312028,0,0,3,-3,17
1974,2022-03-02,VIRAC,13.5803594,124.2312028,1,0,3,-2,15
1977,2022-03-04,VIRAC,13.5803594,124.2312028,0,0,1,-1,14
1979,2022-03-05,VIRAC,13.5803594,124.2312028,0,0,3,-3,11
1985,2022-03-08,VIRAC,13.5803594,124.2312028,0,0,1,-1,10
1997,2022-03-25,VIRAC,13.5803594,124.2312028,1,0,0,1,11
1998,2022-03-27,VIRAC,13.5803594,124.2312028,0,0,1,-1,10
2001,2022-04-04,VIRAC,13.5803594,124.2312028,1,0,1,0,10
2010,2022-04-15,VIRAC,13.5803594,124.2312028,0,0,1,-1,9
2011,2022-04-20,VIRAC,13.5803594,124.2312028,0,0,1,-1,8
2017,2022-04-30,VIRAC,13.5803594,124.2312028,0,0,1,-1,7
2027,2022-05-12,VIRAC,13.5803594,124.2312028,1,0,0,1,8
2029,2022-05-14,VIRAC,13.5803594,124.2312028,0,0,1,-1,7
2030,2022-05-16,VIRAC,13.5803594,124.2312028,0,0,1,-1,6
2033,2022-05-18,VIRAC,13.5803594,124.2312028,0,0,2,-2,4
2034,2022-05-19,VIRAC,13.5803594,124.2312028,0,0,1,-1,3
2036,2022-05-22,VIRAC,13.5803594,124.2312028,0,0,1,-1,2
2037,2022-05-26,VIRAC,13.5803594,124.2312028,1,0,0,1,3
2038,2022-05-27,VIRAC,13.5803594,124.2312028,1,0,0,1,4
2039,2022-05-28,VIRAC,13.5803594,124.2312028,1,0,0,1,5
2041,2022-06-04,VIRAC,13.5803594,124.2312028,0,0,1,-1,4
2042,2022-06-06,VIRAC,13.5803594,124.2312028,0,0,2,-2,2
2044,2022-06-08,VIRAC,13.5803594,124.2312028,2,0,0,2,4
2046,2022-06-17,VIRAC,13.5803594,124.2312028,1,0,0,1,5
2049,2022-06-18,VIRAC,13.5803594,124.2312028,1,0,2,-1,4
2052,2022-06-22,VIRAC,13.5803594,124.2312028,3,0,0,3,7
2055,2022-06-26,VIRAC,13.5803594,124.2312028,0,0,1,-1,6
2056,2022-06-27,VIRAC,13.5803594,124.2312028,1,0,0,1,7
2057,2022-06-29,VIRAC,13.5803594,124.2312028,1,0,1,0,7
2060,2022-06-30,VIRAC,13.5803594,124.2312028,2,0,0,2,9
2061,2022-07-01,VIRAC,13.5803594,124.2312028,1,0,0,1,10
2062,2022-07-02,VIRAC,13.5803594,124.2312028,1,0,4,-3,7
2067,2022-07-05,VIRAC,13.5803594,124.2312028,1,0,0,1,8
2068,2022-07-06,VIRAC,13.5803594,124.2312028,5,0,0,5,13
2073,2022-07-08,VIRAC,13.5803594,124.2312028,1,0,0,1,14
2075,2022-07-09,VIRAC,13.5803594,124.2312028,6,0,1,5,19
2076,2022-07-10,VIRAC,13.5803594,124.2312028,1,0,2,-1,18
2079,2022-07-11,VIRAC,13.5803594,124.2312028,1,0,1,0,18
2081,2022-07-12,VIRAC,13.5803594,124.2312028,0,0,1,-1,17
2085,2022-07-13,VIRAC,13.5803594,124.2312028,2,0,0,2,19
2087,2022-07-14,VIRAC,13.5803594,124.2312028,2,0,1,1,20
2088,2022-07-15,VIRAC,13.5803594,124.2312028,4,0,1,3,23
2093,2022-07-16,VIRAC,13.5803594,124.2312028,3,0,4,-1,22
2095,2022-07-17,VIRAC,13.5803594,124.2312028,1,0,0,1,23
2100,2022-07-18,VIRAC,13.5803594,124.2312028,1,0,1,0,23
2103,2022-07-19,VIRAC,13.5803594,124.2312028,1,0,6,-5,18
2110,2022-07-20,VIRAC,13.5803594,124.2312028,1,0,0,1,19
2111,2022-07-21,VIRAC,13.5803594,124.2312028,4,0,0,4,23
2115,2022-07-22,VIRAC,13.5803594,124.2312028,2,0,0,2,25
2118,2022-07-23,VIRAC,13.5803594,124.2312028,4,0,2,2,27
2121,2022-07-24,VIRAC,13.5803594,124.2312028,0,0,3,-3,24
2128,2022-07-25,VIRAC,13.5803594,124.2312028,0,0,2,-2,22
2130,2022-07-26,VIRAC,13.5803594,124.2312028,1,0,3,-2,20
2133,2022-07-27,VIRAC,13.5803594,124.2312028,2,0,2,0,20
2138,2022-07-28,VIRAC,13.5803594,124.2312028,3,0,0,3,23
2144,2022-07-30,VIRAC,13.5803594,124.2312028,4,0,3,1,24
2147,2022-07-31,VIRAC,13.5803594,124.2312028,0,0,2,-2,22
2151,2022-08-01,VIRAC,13.5803594,124.2312028,1,0,2,-1,21
2155,2022-08-02,VIRAC,13.5803594,124.2312028,0,0,4,-4,17
2157,2022-08-03,VIRAC,13.5803594,124.2312028,11,0,2,9,26
2166,2022-08-04,VIRAC,13.5803594,124.2312028,4,0,0,4,30
2173,2022-08-06,VIRAC,13.5803594,124.2312028,3,0,2,1,31
2176,2022-08-07,VIRAC,13.5803594,124.2312028,3,0,2,1,32
2182,2022-08-09,VIRAC,13.5803594,124.2312028,1,0,4,-3,29
2188,2022-08-10,VIRAC,13.5803594,124.2312028,3,0,1,2,31
2192,2022-08-11,VIRAC,13.5803594,124.2312028,3,0,0,3,34
2196,2022-08-13,VIRAC,13.5803594,124.2312028,0,0,10,-10,24
2204,2022-08-14,VIRAC,13.5803594,124.2312028,0,0,3,-3,21
2211,2022-08-15,VIRAC,13.5803594,124.2312028,0,0,3,-3,18
2219,2022-08-17,VIRAC,13.5803594,124.2312028,2,0,3,-1,17
2221,2022-08-18,VIRAC,13.5803594,124.2312028,1,0,1,0,17
2223,2022-08-19,VIRAC,13.5803594,124.2312028,0,0,1,-1,16
2229,2022-08-20,VIRAC,13.5803594,124.2312028,0,1,5,-6,10
2232,2022-08-21,VIRAC,13.5803594,124.2312028,2,0,0,2,12
2247,2022-08-25,VIRAC,13.5803594,124.2312028,2,0,0,2,14
2252,2022-08-27,VIRAC,13.5803594,124.2312028,0,0,2,-2,12
2256,2022-08-28,VIRAC,13.5803594,124.2312028,1,0,1,0,12
2263,2022-08-31,VIRAC,13.5803594,124.2312028,0,0,2,-2,10
2268,2022-09-01,VIRAC,13.5803594,124.2312028,2,0,0,2,12
2272,2022-09-03,VIRAC,13.5803594,124.2312028,0,0,1,-1,11
2275,2022-09-04,VIRAC,13.5803594,124.2312028,2,1,0,1,12
2277,2022-09-06,VIRAC,13.5803594,124.2312028,0,0,1,-1,11
2279,2022-09-07,VIRAC,13.5803594,124.2312028,0,0,1,-1,10
2281,2022-09-09,VIRAC,13.5803594,124.2312028,1,0,1,0,10
2283,2022-09-11,VIRAC,13.5803594,124.2312028,0,0,2,-2,8
2288,2022-09-14,VIRAC,13.5803594,124.2312028,0,0,2,-2,6
2290,2022-09-17,VIRAC,13.5803594,124.2312028,1,0,0,1,7
2292,2022-09-18,VIRAC,13.5803594,124.2312028,3,0,2,1,8
2296,2022-09-22,VIRAC,13.5803594,124.2312028,1,0,0,1,9
2297,2022-09-23,VIRAC,13.5803594,124.2312028,1,0,0,1,10
2299,2022-09-24,VIRAC,13.5803594,124.2312028,1,0,0,1,11
2301,2022-09-26,VIRAC,13.5803594,124.2312028,0,0,1,-1,10
2304,2022-09-28,VIRAC,13.5803594,124.2312028,0,0,2,-2,8
2307,2022-09-30,VIRAC,13.5803594,124.2312028,0,0,4,-4,4
2310,2022-10-01,VIRAC,13.5803594,124.2312028,1,0,0,1,5
2312,2022-10-02,VIRAC,13.5803594,124.2312028,0,0,1,-1,4
2314,2022-10-06,VIRAC,13.5803594,124.2312028,1,0,0,1,5
2317,2022-10-10,VIRAC,13.5803594,124.2312028,0,0,1,-1,4
2318,2022-10-12,VIRAC,13.5803594,124.2312028,1,0,1,0,4
2319,2022-10-13,VIRAC,13.5803594,124.2312028,1,0,0,1,5
2320,2022-10-15,VIRAC,13.5803594,124.2312028,0,0,1,-1,4
2324,2022-10-21,VIRAC,13.5803594,124.2312028,0,0,1,-1,3
2327,2022-11-04,VIRAC,13.5803594,124.2312028,0,0,1,-1,2
2329,2022-11-25,VIRAC,13.5803594,124.2312028,1,0,0,1,3
2330,2022-11-28,VIRAC,13.5803594,124.2312028,1,0,0,1,4
2331,2022-12-04,VIRAC,13.5803594,124.2312028,0,0,1,-1,3
2332,2022-12-06,VIRAC,13.5803594,124.2312028,0,0,1,-1,2
2334,2023-03-04,VIRAC,13.5803594,124.2312028,0,0,2,-2,0
2335,2023-03-17,VIRAC,13.5803594,124.2312028,1,0,0,1,1
2336,2023-03-22,VIRAC,13.5803594,124.2312028,1,0,0,1,2
2337,2023-03-26,VIRAC,13.5803594,124.2312028,0,0,1,-1,1
2338,2023-03-31,VIRAC,13.5803594,124.2312028,1,0,0,1,2
2339,2023-04-01,VIRAC,13.5803594,124.2312028,0,0,1,-1,1
2341,2023-04-07,VIRAC,13.5803594,124.2312028,1,0,0,1,2
2343,2023-04-17,VIRAC,13.5803594,124.2312028,0,0,1,-1,1
2349,2023-04-30,VIRAC,13.5803594,124.2312028,4,0,0,4,5
2352,2023-05-04,VIRAC,13.5803594,124.2312028,3,0,0,3,8
2356,2023-05-07,VIRAC,13.5803594,124.2312028,2,0,0,2,10
2359,2023-05-08,VIRAC,13.5803594,124.2312028,1,0,1,0,10
2360,2023-05-09,VIRAC,13.5803594,124.2312028,0,0,3,-3,7
2363,2023-05-10,VIRAC,13.5803594,124.2312028,4,0,0,4,11
2367,2023-05-12,VIRAC,13.5803594,124.2312028,4,0,0,4,15
2368,2023-05-13,VIRAC,13.5803594,124.2312028,0,0,3,-3,12
2369,2023-05-14,VIRAC,13.5803594,124.2312028,3,0,0,3,15
2379,2023-05-16,VIRAC,13.5803594,124.2312028,0,0,3,-3,12
2380,2023-05-17,VIRAC,13.5803594,124.2312028,6,0,0,6,18
2388,2023-05-19,VIRAC,13.5803594,124.2312028,5,0,4,1,19
2397,2023-05-21,VIRAC,13.5803594,124.2312028,6,0,4,2,21
2401,2023-05-22,VIRAC,13.5803594,124.2312028,1,0,0,1,22
2403,2023-05-23,VIRAC,13.5803594,124.2312028,0,0,2,-2,20
2410,2023-05-24,VIRAC,13.5803594,124.2312028,4,0,0,4,24
2416,2023-05-26,VIRAC,13.5803594,124.2312028,5,0,6,-1,23
2430,2023-05-28,VIRAC,13.5803594,124.2312028,5,0,5,0,23
2432,2023-05-29,VIRAC,13.5803594,124.2312028,1,0,0,1,24
2439,2023-05-30,VIRAC,13.5803594,124.2312028,0,0,7,-7,17
2441,2023-05-31,VIRAC,13.5803594,124.2312028,6,0,0,6,23
2445,2023-06-01,VIRAC,13.5803594,124.2312028,0,0,2,-2,21
2450,2023-06-02,VIRAC,13.5803594,124.2312028,0,0,2,-2,19
2454,2023-06-03,VIRAC,13.5803594,124.2312028,6,0,0,6,25
2463,2023-06-04,VIRAC,13.5803594,124.2312028,5,0,5,0,25
2466,2023-06-05,VIRAC,13.5803594,124.2312028,1,0,0,1,26
2467,2023-06-06,VIRAC,13.5803594,124.2312028,0,0,5,-5,21
2476,2023-06-07,VIRAC,13.5803594,124.2312028,0,0,1,-1,20
2479,2023-06-09,VIRAC,13.5803594,124.2312028,4,0,5,-1,19
2485,2023-06-10,VIRAC,13.5803594,124.2312028,0,0,2,-2,17
2487,2023-06-11,VIRAC,13.5803594,124.2312028,4,0,4,0,17
2491,2023-06-13,VIRAC,13.5803594,124.2312028,0,0,5,-5,12
2494,2023-06-14,VIRAC,13.5803594,124.2312028,0,0,1,-1,11
2496,2023-06-15,VIRAC,13.5803594,124.2312028,1,0,0,1,12
2499,2023-06-16,VIRAC,13.5803594,124.2312028,1,0,1,0,12
2503,2023-06-18,VIRAC,13.5803594,124.2312028,0,0,3,-3,9
2505,2023-06-20,VIRAC,13.5803594,124.2312028,0,0,4,-4,5
2507,2023-06-24,VIRAC,13.5803594,124.2312028,0,0,2,-2,3
2510,2023-06-28,VIRAC,13.5803594,124.2312028,1,0,0,1,4
2513,2023-07-01,VIRAC,13.5803594,124.2312028,0,0,1,-1,3
2516,2023-07-07,VIRAC,13.5803594,124.2312028,1,0,1,0,3
2518,2023-07-08,VIRAC,13.5803594,124.2312028,1,0,0,1,4
2521,2023-07-16,VIRAC,13.5803594,124.2312028,0,0,2,-2,2
2522,2023-07-21,VIRAC,13.5803594,124.2312028,1,0,0,1,3
2523,2023-07-30,VIRAC,13.5803594,124.2312028,0,0,1,-1,2
2524,2023-08-04,VIRAC,13.5803594,124.2312028,0,0,1,-1,1
2535,2023-09-23,VIRAC,13.5803594,124.2312028,1,0,0,1,2
2537,2023-10-01,VIRAC,13.5803594,124.2312028,0,0,1,-1,1
2542,2023-11-16,VIRAC,13.5803594,124.2312028,1,0,0,1,2
2543,2023-11-23,VIRAC,13.5803594,124.2312028,1,0,0,1,3
2544,2023-11-24,VIRAC,13.5803594,124.2312028,0,0,1,-1,2
2546,2023-12-01,VIRAC,13.5803594,124.2312028,0,0,1,-1,1
2547,2023-12-03,VIRAC,13.5803594,124.2312028,1,0,0,1,2
2550,2023-12-07,VIRAC,13.5803594,124.2312028,2,0,0,2,4
2551,2023-12-09,VIRAC,13.5803594,124.2312028,2,0,0,2,6
2552,2023-12-12,VIRAC,13.5803594,124.2312028,0,0,1,-1,5
2555,2023-12-14,VIRAC,13.5803594,124.2312028,2,0,0,2,7
2558,2023-12-15,VIRAC,13.5803594,124.2312028,0,0,2,-2,5
2559,2023-12-16,VIRAC,13.5803594,124.2312028,0,0,1,-1,4
2560,2023-12-17,VIRAC,13.5803594,124.2312028,2,0,1,1,5
2563,2023-12-23,VIRAC,13.5803594,124.2312028,0,0,2,-2,3
2564,2023-12-24,VIRAC,13.5803594,124.2312028,2,0,0,2,5
2566,2023-12-25,VIRAC,13.5803594,124.2312028,0,0,2,-2,3
2569,2023-12-31,VIRAC,13.5803594,124.2312028,2,0,0,2,5
2570,2024-01-01,VIRAC,13.5803594,124.2312028,0,0,2,-2,3
2574,2024-01-08,VIRAC,13.5803594,124.2312028,0,0,2,-2,1
3,2020-07-08,CARAMORAN,13.9838351,124.1338718,1,0,0,1,1
15,2020-07-30,CARAMORAN,13.9838351,124.1338718,0,0,1,-1,0
19,2020-08-04,CARAMORAN,13.9838351,124.1338718,1,0,0,1,1
34,2020-08-16,CARAMORAN,13.9838351,124.1338718,0,0,1,-1,0
52,2020-08-29,CARAMORAN,13.9838351,124.1338718,1,0,0,1,1
68,2020-09-12,CARAMORAN,13.9838351,124.1338718,1,0,0,1,2
82,2020-09-20,CARAMORAN,13.9838351,124.1338718,0,0,1,-1,1
92,2020-09-27,CARAMORAN,13.9838351,124.1338718,0,0,1,-1,0
111,2020-10-16,CARAMORAN,13.9838351,124.1338718,1,0,0,1,1
124,2020-10-25,CARAMORAN,13.9838351,124.1338718,0,0,1,-1,0
209,2021-02-14,CARAMORAN,13.9838351,124.1338718,2,0,0,2,2
233,2021-02-28,CARAMORAN,13.9838351,124.1338718,0,0,1,-1,1
242,2021-03-06,CARAMORAN,13.9838351,124.1338718,1,0,0,1,2
255,2021-03-13,CARAMORAN,13.9838351,124.1338718,0,0,1,-1,1
266,2021-03-21,CARAMORAN,13.9838351,124.1338718,0,0,1,-1,0
270,2021-03-25,CARAMORAN,13.9838351,124.1338718,1,0,0,1,1
284,2021-04-01,CARAMORAN,13.9838351,124.1338718,1,0,0,1,2
300,2021-04-08,CARAMORAN,13.9838351,124.1338718,1,0,0,1,3
302,2021-04-10,CARAMORAN,13.9838351,124.1338718,1,0,0,1,4
308,2021-04-11,CARAMORAN,13.9838351,124.1338718,0,0,1,-1,3
309,2021-04-15,CARAMORAN,13.9838351,124.1338718,1,0,0,1,4
313,2021-04-18,CARAMORAN,13.9838351,124.1338718,0,0,1,-1,3
329,2021-04-22,CARAMORAN,13.9838351,124.1338718,0,0,1,-1,2
333,2021-04-23,CARAMORAN,13.9838351,124.1338718,1,0,0,1,3
334,2021-04-24,CARAMORAN,13.9838351,124.1338718,0,0,2,-2,1
353,2021-05-01,CARAMORAN,13.9838351,124.1338718,0,0,1,-1,0
394,2021-05-13,CARAMORAN,13.9838351,124.1338718,1,0,0,1,1
399,2021-05-15,CARAMORAN,13.9838351,124.1338718,1,0,0,1,2
423,2021-05-20,CARAMORAN,13.9838351,124.1338718,3,0,0,3,5
429,2021-05-21,CARAMORAN,13.9838351,124.1338718,0,0,1,-1,4
436,2021-05-24,CARAMORAN,13.9838351,124.1338718,0,0,1,-1,3
451,2021-05-26,CARAMORAN,13.9838351,124.1338718,1,0,0,1,4
454,2021-05-27,CARAMORAN,13.9838351,124.1338718,2,0,0,2,6
457,2021-05-28,CARAMORAN,13.9838351,124.1338718,1,0,0,1,7
462,2021-05-29,CARAMORAN,13.9838351,124.1338718,3,0,3,0,7
469,2021-05-31,CARAMORAN,13.9838351,124.1338718,3,0,1,2,9
487,2021-06-03,CARAMORAN,13.9838351,124.1338718,2,0,0,2,11
493,2021-06-05,CARAMORAN,13.9838351,124.1338718,0,0,2,-2,9
497,2021-06-06,CARAMORAN,13.9838351,124.1338718,0,0,1,-1,8
502,2021-06-07,CARAMORAN,13.9838351,124.1338718,3,0,3,0,8
507,2021-06-09,CARAMORAN,13.9838351,124.1338718,3,0,3,0,8
515,2021-06-12,CARAMORAN,13.9838351,124.1338718,0,0,2,-2,6
523,2021-06-13,CARAMORAN,13.9838351,124.1338718,2,0,0,2,8
529,2021-06-15,CARAMORAN,13.9838351,124.1338718,2,0,3,-1,7
534,2021-06-16,CARAMORAN,13.9838351,124.1338718,0,0,3,-3,4
537,2021-06-17,CARAMORAN,13.9838351,124.1338718,1,0,0,1,5
551,2021-06-21,CARAMORAN,13.9838351,124.1338718,2,0,1,1,6
554,2021-06-23,CARAMORAN,13.9838351,124.1338718,0,0,2,-2,4
566,2021-06-25,CARAMORAN,13.9838351,124.1338718,3,0,0,3,7
573,2021-06-26,CARAMORAN,13.9838351,124.1338718,0,0,1,-1,6
583,2021-06-28,CARAMORAN,13.9838351,124.1338718,4,0,0,4,10
589,2021-06-30,CARAMORAN,13.9838351,124.1338718,0,0,2,-2,8
597,2021-07-01,CARAMORAN,13.9838351,124.1338718,2,0,0,2,10
604,2021-07-03,CARAMORAN,13.9838351,124.1338718,1,0,0,1,11
613,2021-07-04,CARAMORAN,13.9838351,124.1338718,0,0,3,-3,8
617,2021-07-05,CARAMORAN,13.9838351,124.1338718,1,0,0,1,9
629,2021-07-07,CARAMORAN,13.9838351,124.1338718,0,0,4,-4,5
643,2021-07-08,CARAMORAN,13.9838351,124.1338718,1,0,0,1,6
648,2021-07-09,CARAMORAN,13.9838351,124.1338718,3,0,0,3,9
657,2021-07-10,CARAMORAN,13.9838351,124.1338718,0,0,1,-1,8
665,2021-07-12,CARAMORAN,13.9838351,124.1338718,6,0,1,5,13
678,2021-07-14,CARAMORAN,13.9838351,124.1338718,0,0,1,-1,12
683,2021-07-15,CARAMORAN,13.9838351,124.1338718,1,0,0,1,13
686,2021-07-16,CARAMORAN,13.9838351,124.1338718,1,0,0,1,14
694,2021-07-17,CARAMORAN,13.9838351,124.1338718,0,1,2,-3,11
704,2021-07-18,CARAMORAN,13.9838351,124.1338718,1,0,3,-2,9
726,2021-07-21,CARAMORAN,13.9838351,124.1338718,0,0,6,-6,3
735,2021-07-24,CARAMORAN,13.9838351,124.1338718,0,0,2,-2,1
756,2021-07-27,CARAMORAN,13.9838351,124.1338718,0,0,1,-1,0
760,2021-07-29,CARAMORAN,13.9838351,124.1338718,1,0,0,1,1
780,2021-08-02,CARAMORAN,13.9838351,124.1338718,1,0,0,1,2
804,2021-08-07,CARAMORAN,13.9838351,124.1338718,1,0,1,0,2
815,2021-08-09,CARAMORAN,13.9838351,124.1338718,1,0,0,1,3
824,2021-08-11,CARAMORAN,13.9838351,124.1338718,0,0,1,-1,2
836,2021-08-14,CARAMORAN,13.9838351,124.1338718,1,0,0,1,3
851,2021-08-16,CARAMORAN,13.9838351,124.1338718,0,0,1,-1,2
858,2021-08-17,CARAMORAN,13.9838351,124.1338718,0,0,1,-1,1
864,2021-08-18,CARAMORAN,13.9838351,124.1338718,0,1,0,-1,0
885,2021-08-22,CARAMORAN,13.9838351,124.1338718,2,0,0,2,2
888,2021-08-23,CARAMORAN,13.9838351,124.1338718,1,0,0,1,3
903,2021-08-26,CARAMORAN,13.9838351,124.1338718,1,0,0,1,4
934,2021-08-31,CARAMORAN,13.9838351,124.1338718,0,0,2,-2,2
937,2021-09-01,CARAMORAN,13.9838351,124.1338718,0,0,1,-1,1
945,2021-09-03,CARAMORAN,13.9838351,124.1338718,1,0,0,1,2
957,2021-09-04,CARAMORAN,13.9838351,124.1338718,0,0,1,-1,1
959,2021-09-05,CARAMORAN,13.9838351,124.1338718,1,0,0,1,2
973,2021-09-06,CARAMORAN,13.9838351,124.1338718,1,0,0,1,3
975,2021-09-07,CARAMORAN,13.9838351,124.1338718,1,0,0,1,4
985,2021-09-09,CARAMORAN,13.9838351,124.1338718,5,0,0,5,9
997,2021-09-11,CARAMORAN,13.9838351,124.1338718,0,0,1,-1,8
1005,2021-09-12,CARAMORAN,13.9838351,124.1338718,6,0,0,6,14
1021,2021-09-14,CARAMORAN,13.9838351,124.1338718,0,0,1,-1,13
1029,2021-09-15,CARAMORAN,13.9838351,124.1338718,0,0,1,-1,12
1033,2021-09-16,CARAMORAN,13.9838351,124.1338718,0,0,1,-1,11
1047,2021-09-17,CARAMORAN,13.9838351,124.1338718,2,0,0,2,13
1049,2021-09-18,CARAMORAN,13.9838351,124.1338718,0,0,5,-5,8
1063,2021-09-20,CARAMORAN,13.9838351,124.1338718,0,0,5,-5,3
1076,2021-09-21,CARAMORAN,13.9838351,124.1338718,0,0,1,-1,2
1087,2021-09-23,CARAMORAN,13.9838351,124.1338718,3,0,0,3,5
1100,2021-09-25,CARAMORAN,13.9838351,124.1338718,0,0,1,-1,4
1112,2021-09-26,CARAMORAN,13.9838351,124.1338718,0,0,1,-1,3
1133,2021-09-30,CARAMORAN,13.9838351,124.1338718,1,0,2,-1,2
1142,2021-10-01,CARAMORAN,13.9838351,124.1338718,5,0,1,4,6
1152,2021-10-02,CARAMORAN,13.9838351,124.1338718,2,0,0,2,8
1172,2021-10-06,CARAMORAN,13.9838351,124.1338718,18,0,0,18,26
1180,2021-10-08,CARAMORAN,13.9838351,124.1338718,1,0,0,1,27
1192,2021-10-09,CARAMORAN,13.9838351,124.1338718,0,0,6,-6,21
1197,2021-10-10,CARAMORAN,13.9838351,124.1338718,1,0,0,1,22
1210,2021-10-11,CARAMORAN,13.9838351,124.1338718,14,0,0,14,36
1220,2021-10-12,CARAMORAN,13.9838351,124.1338718,0,0,2,-2,34
1229,2021-10-14,CARAMORAN,13.9838351,124.1338718,0,0,18,-18,16
1232,2021-10-15,CARAMORAN,13.9838351,124.1338718,6,0,0,6,22
1248,2021-10-16,CARAMORAN,13.9838351,124.1338718,4,0,0,4,26
1252,2021-10-17,CARAMORAN,13.9838351,124.1338718,0,0,1,-1,25
1267,2021-10-18,CARAMORAN,13.9838351,124.1338718,8,0,14,-6,19
1275,2021-10-19,CARAMORAN,13.9838351,124.1338718,0,0,1,-1,18
1299,2021-10-22,CARAMORAN,13.9838351,124.1338718,7,0,0,7,25
1304,2021-10-23,CARAMORAN,13.9838351,124.1338718,2,0,7,-5,20
1321,2021-10-24,CARAMORAN,13.9838351,124.1338718,1,0,4,-3,17
1324,2021-10-25,CARAMORAN,13.9838351,124.1338718,14,0,0,14,31
1335,2021-10-26,CARAMORAN,13.9838351,124.1338718,0,0,7,-7,24
1344,2021-10-27,CARAMORAN,13.9838351,124.1338718,0,0,1,-1,23
1362,2021-10-30,CARAMORAN,13.9838351,124.1338718,8,0,7,1,24
1372,2021-10-31,CARAMORAN,13.9838351,124.1338718,2,0,0,2,26
1386,2021-11-01,CARAMORAN,13.9838351,124.1338718,13,0,1,12,38
1395,2021-11-02,CARAMORAN,13.9838351,124.1338718,0,0,15,-15,23
1411,2021-11-05,CARAMORAN,13.9838351,124.1338718,14,0,0,14,37
1431,2021-11-07,CARAMORAN,13.9838351,124.1338718,4,0,8,-4,33
1437,2021-11-08,CARAMORAN,13.9838351,124.1338718,4,0,0,4,37
1448,2021-11-09,CARAMORAN,13.9838351,124.1338718,0,0,15,-15,22
1478,2021-11-12,CARAMORAN,13.9838351,124.1338718,6,0,0,6,28
1483,2021-11-13,CARAMORAN,13.9838351,124.1338718,12,0,13,-1,27
1491,2021-11-14,CARAMORAN,13.9838351,124.1338718,0,0,1,-1,26
1501,2021-11-15,CARAMORAN,13.9838351,124.1338718,7,0,3,4,30
1512,2021-11-16,CARAMORAN,13.9838351,124.1338718,0,0,5,-5,25
1542,2021-11-20,CARAMORAN,13.9838351,124.1338718,3,0,4,-1,24
1551,2021-11-21,CARAMORAN,13.9838351,124.1338718,0,0,13,-13,11
1569,2021-11-23,CARAMORAN,13.9838351,124.1338718,0,0,7,-7,4
1577,2021-11-25,CARAMORAN,13.9838351,124.1338718,6,0,0,6,10
1583,2021-11-26,CARAMORAN,13.9838351,124.1338718,3,0,0,3,13
1603,2021-11-28,CARAMORAN,13.9838351,124.1338718,1,0,3,-2,11
1617,2021-12-03,CARAMORAN,13.9838351,124.1338718,0,0,6,-6,5
1620,2021-12-04,CARAMORAN,13.9838351,124.1338718,1,1,0,0,5
1624,2021-12-05,CARAMORAN,13.9838351,124.1338718,0,0,3,-3,2
1633,2021-12-08,CARAMORAN,13.9838351,124.1338718,0,0,1,-1,1
1641,2021-12-14,CARAMORAN,13.9838351,124.1338718,0,0,1,-1,0
1643,2021-12-15,CARAMORAN,13.9838351,124.1338718,2,0,0,2,2
1651,2021-12-23,CARAMORAN,13.9838351,124.1338718,1,0,0,1,3
1652,2021-12-25,CARAMORAN,13.9838351,124.1338718,0,0,2,-2,1
1654,2021-12-31,CARAMORAN,13.9838351,124.1338718,1,0,0,1,2
1658,2022-01-01,CARAMORAN,13.9838351,124.1338718,0,0,1,-1,1
1664,2022-01-06,CARAMORAN,13.9838351,124.1338718,1,0,0,1,2
1673,2022-01-09,CARAMORAN,13.9838351,124.1338718,0,0,1,-1,1
1689,2022-01-13,CARAMORAN,13.9838351,124.1338718,5,0,0,5,6
1700,2022-01-15,CARAMORAN,13.9838351,124.1338718,4,0,1,3,9
1709,2022-01-16,CARAMORAN,13.9838351,124.1338718,1,0,0,1,10
1719,2022-01-17,CARAMORAN,13.9838351,124.1338718,1,0,0,1,11
1744,2022-01-20,CARAMORAN,13.9838351,124.1338718,1,0,0,1,12
1745,2022-01-21,CARAMORAN,13.9838351,124.1338718,2,0,5,-3,9
1763,2022-01-22,CARAMORAN,13.9838351,124.1338718,3,0,0,3,12
1766,2022-01-23,CARAMORAN,13.9838351,124.1338718,3,0,2,1,13
1777,2022-01-24,CARAMORAN,13.9838351,124.1338718,2,0,1,1,14
1790,2022-01-25,CARAMORAN,13.9838351,124.1338718,2,0,0,2,16
1795,2022-01-26,CARAMORAN,13.9838351,124.1338718,1,0,2,-1,15
1807,2022-01-27,CARAMORAN,13.9838351,124.1338718,5,0,1,4,19
1815,2022-01-28,CARAMORAN,13.9838351,124.1338718,2,0,0,2,21
1826,2022-01-29,CARAMORAN,13.9838351,124.1338718,1,0,0,1,22
1835,2022-01-30,CARAMORAN,13.9838351,124.1338718,1,0,3,-2,20
1837,2022-01-31,CARAMORAN,13.9838351,124.1338718,0,0,3,-3,17
1848,2022-02-01,CARAMORAN,13.9838351,124.1338718,0,0,2,-2,15
1855,2022-02-02,CARAMORAN,13.9838351,124.1338718,3,0,4,-1,14
1863,2022-02-04,CARAMORAN,13.9838351,124.1338718,1,0,1,0,14
1875,2022-02-05,CARAMORAN,13.9838351,124.1338718,0,0,5,-5,9
1886,2022-02-06,CARAMORAN,13.9838351,124.1338718,2,0,2,0,9
1893,2022-02-07,CARAMORAN,13.9838351,124.1338718,0,0,2,-2,7
1897,2022-02-08,CARAMORAN,13.9838351,124.1338718,0,0,1,-1,6
1906,2022-02-09,CARAMORAN,13.9838351,124.1338718,2,0,0,2,8
1915,2022-02-11,CARAMORAN,13.9838351,124.1338718,0,0,3,-3,5
1925,2022-02-13,CARAMORAN,13.9838351,124.1338718,1,0,0,1,6
1931,2022-02-14,CARAMORAN,13.9838351,124.1338718,0,0,1,-1,5
1932,2022-02-15,CARAMORAN,13.9838351,124.1338718,0,0,2,-2,3
1944,2022-02-18,CARAMORAN,13.9838351,124.1338718,0,0,1,-1,2
1949,2022-02-19,CARAMORAN,13.9838351,124.1338718,0,0,1,-1,1
1960,2022-02-23,CARAMORAN,13.9838351,124.1338718,0,0,1,-1,0
1976,2022-03-04,CARAMORAN,13.9838351,124.1338718,2,0,2,0,0
1989,2022-03-13,CARAMORAN,13.9838351,124.1338718,1,0,0,1,1
1993,2022-03-20,CARAMORAN,13.9838351,124.1338718,0,1,0,-1,0
2008,2022-04-15,CARAMORAN,13.9838351,124.1338718,1,0,0,1,1
2016,2022-04-25,CARAMORAN,13.9838351,124.1338718,0,0,1,-1,0
2069,2022-07-07,CARAMORAN,13.9838351,124.1338718,1,0,0,1,1
2090,2022-07-15,CARAMORAN,13.9838351,124.1338718,2,0,0,2,3
2097,2022-07-17,CARAMORAN,13.9838351,124.1338718,0,0,1,-1,2
2113,2022-07-21,CARAMORAN,13.9838351,124.1338718,2,0,0,2,4
2125,2022-07-25,CARAMORAN,13.9838351,124.1338718,0,0,2,-2,2
2140,2022-07-30,CARAMORAN,13.9838351,124.1338718,0,0,2,-2,0
2146,2022-07-31,CARAMORAN,13.9838351,124.1338718,1,0,0,1,1
2159,2022-08-03,CARAMORAN,13.9838351,124.1338718,1,0,0,1,2
2172,2022-08-05,CARAMORAN,13.9838351,124.1338718,1,0,0,1,3
2183,2022-08-09,CARAMORAN,13.9838351,124.1338718,0,0,1,-1,2
2200,2022-08-13,CARAMORAN,13.9838351,124.1338718,0,0,1,-1,1
2206,2022-08-14,CARAMORAN,13.9838351,124.1338718,1,0,0,1,2
2230,2022-08-20,CARAMORAN,13.9838351,124.1338718,1,0,0,1,3
2245,2022-08-24,CARAMORAN,13.9838351,124.1338718,0,0,1,-1,2
2248,2022-08-25,CARAMORAN,13.9838351,124.1338718,1,0,0,1,3
2257,2022-08-28,CARAMORAN,13.9838351,124.1338718,1,0,1,0,3
2271,2022-09-02,CARAMORAN,13.9838351,124.1338718,1,0,1,0,3
2278,2022-09-07,CARAMORAN,13.9838351,124.1338718,0,0,1,-1,2
2286,2022-09-12,CARAMORAN,13.9838351,124.1338718,0,0,1,-1,1
2311,2022-10-01,CARAMORAN,13.9838351,124.1338718,1,0,0,1,2
2321,2022-10-15,CARAMORAN,13.9838351,124.1338718,1,0,0,1,3
2323,2022-10-16,CARAMORAN,13.9838351,124.1338718,0,0,1,-1,2
2326,2022-11-04,CARAMORAN,13.9838351,124.1338718,0,0,1,-1,1
2333,2023-03-04,CARAMORAN,13.9838351,124.1338718,0,0,1,-1,0
2351,2023-05-01,CARAMORAN,13.9838351,124.1338718,1,0,0,1,1
2354,2023-05-07,CARAMORAN,13.9838351,124.1338718,1,0,0,1,2
2361,2023-05-09,CARAMORAN,13.9838351,124.1338718,0,0,1,-1,1
2378,2023-05-16,CARAMORAN,13.9838351,124.1338718,0,0,1,-1,0
2381,2023-05-17,CARAMORAN,13.9838351,124.1338718,1,0,0,1,1
2385,2023-05-19,CARAMORAN,13.9838351,124.1338718,3,0,0,3,4
2400,2023-05-22,CARAMORAN,13.9838351,124.1338718,1,0,0,1,5
2412,2023-05-24,CARAMORAN,13.9838351,124.1338718,3,0,0,3,8
2415,2023-05-26,CARAMORAN,13.9838351,124.1338718,3,0,1,2,10
2419,2023-05-27,CARAMORAN,13.9838351,124.1338718,2,0,0,2,12
2426,2023-05-28,CARAMORAN,13.9838351,124.1338718,0,0,3,-3,9
2436,2023-05-30,CARAMORAN,13.9838351,124.1338718,0,0,1,-1,8
2451,2023-06-02,CARAMORAN,13.9838351,124.1338718,0,0,3,-3,5
2453,2023-06-03,CARAMORAN,13.9838351,124.1338718,4,0,0,4,9
2460,2023-06-04,CARAMORAN,13.9838351,124.1338718,0,0,5,-5,4
2488,2023-06-11,CARAMORAN,13.9838351,124.1338718,0,0,4,-4,0
2500,2023-06-17,CARAMORAN,13.9838351,124.1338718,1,0,0,1,1
2509,2023-06-26,CARAMORAN,13.9838351,124.1338718,0,0,1,-1,0
2527,2023-08-04,CARAMORAN,13.9838351,124.1338718,2,0,0,2,2
2528,2023-08-13,CARAMORAN,13.9838351,124.1338718,0,0,2,-2,0
2534,2023-09-17,CARAMORAN,13.9838351,124.1338718,1,0,0,1,1
2536,2023-09-24,CARAMORAN,13.9838351,124.1338718,0,0,1,-1,0
2538,2023-10-01,CARAMORAN,13.9838351,124.1338718,1,0,0,1,1
2540,2023-10-10,CARAMORAN,13.9838351,124.1338718,0,0,1,-1,0
2549,2023-12-07,CARAMORAN,13.9838351,124.1338718,1,0,0,1,1
2554,2023-12-14,CARAMORAN,13.9838351,124.1338718,1,0,0,1,2
2557,2023-12-15,CARAMORAN,13.9838351,124.1338718,0,0,1,-1,1
2562,2023-12-23,CARAMORAN,13.9838351,124.1338718,0,0,1,-1,0
8,2020-07-19,GIGMOTO,13.7786693,124.3911728,2,0,0,2,2
24,2020-08-10,GIGMOTO,13.7786693,124.3911728,0,0,1,-1,1
32,2020-08-16,GIGMOTO,13.7786693,124.3911728,0,0,1,-1,0
125,2020-10-28,GIGMOTO,13.7786693,124.3911728,1,0,0,1,1
131,2020-11-01,GIGMOTO,13.7786693,124.3911728,1,0,0,1,2
142,2020-11-15,GIGMOTO,13.7786693,124.3911728,0,0,2,-2,0
161,2020-12-21,GIGMOTO,13.7786693,124.3911728,1,0,0,1,1
171,2021-01-03,GIGMOTO,13.7786693,124.3911728,0,0,1,-1,0
363,2021-05-04,GIGMOTO,13.7786693,124.3911728,1,0,0,1,1
393,2021-05-12,GIGMOTO,13.7786693,124.3911728,0,0,1,-1,0
450,2021-05-26,GIGMOTO,13.7786693,124.3911728,1,0,0,1,1
473,2021-05-31,GIGMOTO,13.7786693,124.3911728,0,0,1,-1,0
560,2021-06-24,GIGMOTO,13.7786693,124.3911728,1,0,0,1,1
567,2021-06-25,GIGMOTO,13.7786693,124.3911728,1,0,0,1,2
606,2021-07-03,GIGMOTO,13.7786693,124.3911728,0,0,1,-1,1
612,2021-07-04,GIGMOTO,13.7786693,124.3911728,0,0,1,-1,0
634,2021-07-08,GIGMOTO,13.7786693,124.3911728,1,0,0,1,1
693,2021-07-17,GIGMOTO,13.7786693,124.3911728,0,0,1,-1,0
706,2021-07-18,GIGMOTO,13.7786693,124.3911728,1,0,0,1,1
747,2021-07-26,GIGMOTO,13.7786693,124.3911728,3,0,0,3,4
757,2021-07-27,GIGMOTO,13.7786693,124.3911728,0,0,1,-1,3
789,2021-08-04,GIGMOTO,13.7786693,124.3911728,0,0,3,-3,0
797,2021-08-05,GIGMOTO,13.7786693,124.3911728,3,0,0,3,3
831,2021-08-12,GIGMOTO,13.7786693,124.3911728,4,0,0,4,7
832,2021-08-13,GIGMOTO,13.7786693,124.3911728,2,0,0,2,9
837,2021-08-14,GIGMOTO,13.7786693,124.3911728,0,0,3,-3,6
846,2021-08-15,GIGMOTO,13.7786693,124.3911728,1,0,0,1,7
855,2021-08-17,GIGMOTO,13.7786693,124.3911728,1,0,0,1,8
871,2021-08-19,GIGMOTO,13.7786693,124.3911728,1,0,0,1,9
879,2021-08-21,GIGMOTO,13.7786693,124.3911728,1,0,4,-3,6
883,2021-08-22,GIGMOTO,13.7786693,124.3911728,1,0,2,-1,5
897,2021-08-24,GIGMOTO,13.7786693,124.3911728,0,0,1,-1,4
901,2021-08-25,GIGMOTO,13.7786693,124.3911728,0,0,1,-1,3
910,2021-08-27,GIGMOTO,13.7786693,124.3911728,2,0,0,2,5
913,2021-08-28,GIGMOTO,13.7786693,124.3911728,1,0,1,0,5
929,2021-08-30,GIGMOTO,13.7786693,124.3911728,0,0,1,-1,4
935,2021-08-31,GIGMOTO,13.7786693,124.3911728,0,0,1,-1,3
947,2021-09-03,GIGMOTO,13.7786693,124.3911728,1,0,0,1,4
956,2021-09-04,GIGMOTO,13.7786693,124.3911728,1,0,0,1,5
960,2021-09-05,GIGMOTO,13.7786693,124.3911728,0,0,2,-2,3
970,2021-09-06,GIGMOTO,13.7786693,124.3911728,1,0,1,0,3
999,2021-09-12,GIGMOTO,13.7786693,124.3911728,1,0,1,0,3
1012,2021-09-13,GIGMOTO,13.7786693,124.3911728,0,0,1,-1,2
1025,2021-09-15,GIGMOTO,13.7786693,124.3911728,0,0,1,-1,1
1065,2021-09-20,GIGMOTO,13.7786693,124.3911728,0,0,1,-1,0
1132,2021-09-29,GIGMOTO,13.7786693,124.3911728,1,0,0,1,1
1176,2021-10-07,GIGMOTO,13.7786693,124.3911728,1,0,0,1,2
1179,2021-10-08,GIGMOTO,13.7786693,124.3911728,0,0,1,-1,1
1200,2021-10-10,GIGMOTO,13.7786693,124.3911728,1,0,0,1,2
1240,2021-10-15,GIGMOTO,13.7786693,124.3911728,1,0,0,1,3
1258,2021-10-17,GIGMOTO,13.7786693,124.3911728,1,0,1,0,3
1265,2021-10-18,GIGMOTO,13.7786693,124.3911728,0,0,1,-1,2
1270,2021-10-19,GIGMOTO,13.7786693,124.3911728,1,0,0,1,3
1301,2021-10-22,GIGMOTO,13.7786693,124.3911728,3,0,0,3,6
1313,2021-10-23,GIGMOTO,13.7786693,124.3911728,5,0,1,4,10
1331,2021-10-25,GIGMOTO,13.7786693,124.3911728,1,0,1,0,10
1349,2021-10-28,GIGMOTO,13.7786693,124.3911728,1,0,1,0,10
1361,2021-10-30,GIGMOTO,13.7786693,124.3911728,0,0,3,-3,7
1381,2021-10-31,GIGMOTO,13.7786693,124.3911728,1,0,5,-4,3
1387,2021-11-01,GIGMOTO,13.7786693,124.3911728,1,0,0,1,4
1392,2021-11-02,GIGMOTO,13.7786693,124.3911728,0,0,1,-1,3
1421,2021-11-06,GIGMOTO,13.7786693,124.3911728,5,0,1,4,7
1435,2021-11-07,GIGMOTO,13.7786693,124.3911728,2,0,0,2,9
1444,2021-11-08,GIGMOTO,13.7786693,124.3911728,9,0,1,8,17
1452,2021-11-09,GIGMOTO,13.7786693,124.3911728,0,0,1,-1,16
1469,2021-11-11,GIGMOTO,13.7786693,124.3911728,2,0,0,2,18
1476,2021-11-12,GIGMOTO,13.7786693,124.3911728,5,0,0,5,23
1488,2021-11-14,GIGMOTO,13.7786693,124.3911728,1,0,3,-2,21
1499,2021-11-15,GIGMOTO,13.7786693,124.3911728,3,0,4,-1,20
1505,2021-11-16,GIGMOTO,13.7786693,124.3911728,0,0,4,-4,16
1515,2021-11-17,GIGMOTO,13.7786693,124.3911728,0,0,5,-5,11
1533,2021-11-19,GIGMOTO,13.7786693,124.3911728,5,0,0,5,16
1541,2021-11-20,GIGMOTO,13.7786693,124.3911728,2,0,6,-4,12
1549,2021-11-21,GIGMOTO,13.7786693,124.3911728,3,0,1,2,14
1558,2021-11-22,GIGMOTO,13.7786693,124.3911728,1,0,0,1,15
1567,2021-11-23,GIGMOTO,13.7786693,124.3911728,0,0,3,-3,12
1571,2021-11-24,GIGMOTO,13.7786693,124.3911728,0,0,1,-1,11
1578,2021-11-25,GIGMOTO,13.7786693,124.3911728,1,0,0,1,12
1590,2021-11-27,GIGMOTO,13.7786693,124.3911728,0,0,4,-4,8
1600,2021-11-28,GIGMOTO,13.7786693,124.3911728,3,0,3,0,8
1609,2021-11-29,GIGMOTO,13.7786693,124.3911728,0,0,3,-3,5
1615,2021-12-01,GIGMOTO,13.7786693,124.3911728,0,0,1,-1,4
1622,2021-12-04,GIGMOTO,13.7786693,124.3911728,1,0,1,0,4
1629,2021-12-07,GIGMOTO,13.7786693,124.3911728,0,0,3,-3,1
1632,2021-12-08,GIGMOTO,13.7786693,124.3911728,2,0,0,2,3
1638,2021-12-12,GIGMOTO,13.7786693,124.3911728,1,0,0,1,4
1647,2021-12-18,GIGMOTO,13.7786693,124.3911728,0,0,2,-2,2
1649,2021-12-21,GIGMOTO,13.7786693,124.3911728,0,0,1,-1,1
1686,2022-01-12,GIGMOTO,13.7786693,124.3911728,1,0,0,1,2
1703,2022-01-15,GIGMOTO,13.7786693,124.3911728,1,0,0,1,3
1714,2022-01-16,GIGMOTO,13.7786693,124.3911728,1,0,0,1,4
1749,2022-01-21,GIGMOTO,13.7786693,124.3911728,3,0,0,3,7
1760,2022-01-22,GIGMOTO,13.7786693,124.3911728,0,0,1,-1,6
1781,2022-01-24,GIGMOTO,13.7786693,124.3911728,2,0,1,1,7
1782,2022-01-25,GIGMOTO,13.7786693,124.3911728,0,0,1,-1,6
1793,2022-01-26,GIGMOTO,13.7786693,124.3911728,2,0,0,2,8
1809,2022-01-28,GIGMOTO,13.7786693,124.3911728,1,0,1,0,8
1819,2022-01-29,GIGMOTO,13.7786693,124.3911728,0,0,1,-1,7
1833,2022-01-30,GIGMOTO,13.7786693,124.3911728,1,0,1,0,7
1842,2022-02-01,GIGMOTO,13.7786693,124.3911728,0,0,2,-2,5
1864,2022-02-04,GIGMOTO,13.7786693,124.3911728,0,0,1,-1,4
1887,2022-02-06,GIGMOTO,13.7786693,124.3911728,1,0,2,-1,3
1894,2022-02-07,GIGMOTO,13.7786693,124.3911728,1,0,0,1,4
1903,2022-02-08,GIGMOTO,13.7786693,124.3911728,0,0,1,-1,3
1930,2022-02-14,GIGMOTO,13.7786693,124.3911728,0,0,1,-1,2
1940,2022-02-16,GIGMOTO,13.7786693,124.3911728,1,0,1,0,2
1945,2022-02-18,GIGMOTO,13.7786693,124.3911728,1,0,0,1,3
1963,2022-02-25,GIGMOTO,13.7786693,124.3911728,2,0,0,2,5
1965,2022-02-26,GIGMOTO,13.7786693,124.3911728,0,0,1,-1,4
1971,2022-02-28,GIGMOTO,13.7786693,124.3911728,0,0,1,-1,3
1982,2022-03-06,GIGMOTO,13.7786693,124.3911728,0,0,1,-1,2
1983,2022-03-07,GIGMOTO,13.7786693,124.3911728,0,0,1,-1,1
2035,2022-05-20,GIGMOTO,13.7786693,124.3911728,0,0,1,-1,0
2127,2022-07-25,GIGMOTO,13.7786693,124.3911728,1,0,0,1,1
2149,2022-07-31,GIGMOTO,13.7786693,124.3911728,3,0,0,3,4
2167,2022-08-04,GIGMOTO,13.7786693,124.3911728,1,0,1,0,4
2170,2022-08-05,GIGMOTO,13.7786693,124.3911728,4,0,0,4,8
2184,2022-08-10,GIGMOTO,13.7786693,124.3911728,1,0,3,-2,6
2191,2022-08-11,GIGMOTO,13.7786693,124.3911728,1,0,0,1,7
2194,2022-08-12,GIGMOTO,13.7786693,124.3911728,2,0,0,2,9
2201,2022-08-13,GIGMOTO,13.7786693,124.3911728,2,0,1,1,10
2207,2022-08-14,GIGMOTO,13.7786693,124.3911728,2,0,2,0,10
2210,2022-08-15,GIGMOTO,13.7786693,124.3911728,1,0,2,-1,9
2215,2022-08-17,GIGMOTO,13.7786693,124.3911728,2,0,0,2,11
2228,2022-08-20,GIGMOTO,13.7786693,124.3911728,0,0,2,-2,9
2233,2022-08-21,GIGMOTO,13.7786693,124.3911728,0,0,1,-1,8
2239,2022-08-22,GIGMOTO,13.7786693,124.3911728,0,0,3,-3,5
2243,2022-08-23,GIGMOTO,13.7786693,124.3911728,0,0,3,-3,2
2251,2022-08-27,GIGMOTO,13.7786693,124.3911728,0,0,2,-2,0
2276,2022-09-04,GIGMOTO,13.7786693,124.3911728,1,0,0,1,1
2287,2022-09-14,GIGMOTO,13.7786693,124.3911728,0,0,1,-1,0
2291,2022-09-18,GIGMOTO,13.7786693,124.3911728,1,0,0,1,1
2306,2022-09-28,GIGMOTO,13.7786693,124.3911728,0,0,1,-1,0
2358,2023-05-07,GIGMOTO,13.7786693,124.3911728,1,0,0,1,1
2375,2023-05-16,GIGMOTO,13.7786693,124.3911728,0,0,1,-1,0
2396,2023-05-21,GIGMOTO,13.7786693,124.3911728,7,0,0,7,7
2423,2023-05-27,GIGMOTO,13.7786693,124.3911728,1,0,0,1,8
2433,2023-05-29,GIGMOTO,13.7786693,124.3911728,0,0,1,-1,7
2434,2023-05-30,GIGMOTO,13.7786693,124.3911728,0,0,6,-6,1
2457,2023-06-03,GIGMOTO,13.7786693,124.3911728,0,0,1,-1,0
2464,2023-06-04,GIGMOTO,13.7786693,124.3911728,1,0,0,1,1
2492,2023-06-13,GIGMOTO,13.7786693,124.3911728,0,0,1,-1,0
2565,2023-12-24,GIGMOTO,13.7786693,124.3911728,1,0,0,1,1
2571,2024-01-01,GIGMOTO,13.7786693,124.3911728,0,0,1,-1,0
12,2020-07-24,BARAS,13.6591045,124.3704682,1,0,0,1,1
17,2020-08-03,BARAS,13.6591045,124.3704682,1,0,0,1,2
20,2020-08-08,BARAS,13.6591045,124.3704682,1,0,0,1,3
25,2020-08-10,BARAS,13.6591045,124.3704682,1,0,0,1,4
27,2020-08-14,BARAS,13.6591045,124.3704682,1,0,0,1,5
31,2020-08-16,BARAS,13.6591045,124.3704682,0,0,2,-2,3
55,2020-08-30,BARAS,13.6591045,124.3704682,0,0,3,-3,0
59,2020-09-05,BARAS,13.6591045,124.3704682,4,0,0,4,4
81,2020-09-20,BARAS,13.6591045,124.3704682,0,0,1,-1,3
91,2020-09-27,BARAS,13.6591045,124.3704682,0,0,3,-3,0
116,2020-10-20,BARAS,13.6591045,124.3704682,1,0,0,1,1
139,2020-11-08,BARAS,13.6591045,124.3704682,0,0,1,-1,0
145,2020-11-18,BARAS,13.6591045,124.3704682,1,0,0,1,1
153,2020-12-06,BARAS,13.6591045,124.3704682,0,0,1,-1,0
213,2021-02-16,BARAS,13.6591045,124.3704682,1,0,0,1,1
248,2021-03-07,BARAS,13.6591045,124.3704682,0,0,1,-1,0
290,2021-04-04,BARAS,13.6591045,124.3704682,1,0,0,1,1
299,2021-04-08,BARAS,13.6591045,124.3704682,1,0,0,1,2
312,2021-04-16,BARAS,13.6591045,124.3704682,1,0,0,1,3
323,2021-04-19,BARAS,13.6591045,124.3704682,1,0,1,0,3
327,2021-04-22,BARAS,13.6591045,124.3704682,0,0,1,-1,2
339,2021-04-25,BARAS,13.6591045,124.3704682,0,0,1,-1,1
340,2021-04-27,BARAS,13.6591045,124.3704682,1,0,0,1,2
347,2021-04-28,BARAS,13.6591045,124.3704682,1,0,0,1,3
352,2021-05-01,BARAS,13.6591045,124.3704682,0,0,1,-1,2
364,2021-05-05,BARAS,13.6591045,124.3704682,0,0,1,-1,1
371,2021-05-07,BARAS,13.6591045,124.3704682,0,0,1,-1,0
395,2021-05-13,BARAS,13.6591045,124.3704682,2,0,0,2,2
406,2021-05-16,BARAS,13.6591045,124.3704682,1,0,0,1,3
430,2021-05-21,BARAS,13.6591045,124.3704682,1,0,0,1,4
432,2021-05-22,BARAS,13.6591045,124.3704682,0,0,2,-2,2
437,2021-05-24,BARAS,13.6591045,124.3704682,6,0,2,4,6
442,2021-05-25,BARAS,13.6591045,124.3704682,3,0,0,3,9
446,2021-05-26,BARAS,13.6591045,124.3704682,3,0,0,3,12
458,2021-05-28,BARAS,13.6591045,124.3704682,1,1,0,0,12
461,2021-05-29,BARAS,13.6591045,124.3704682,1,0,0,1,13
470,2021-05-31,BARAS,13.6591045,124.3704682,0,0,3,-3,10
478,2021-06-01,BARAS,13.6591045,124.3704682,0,0,6,-6,4
484,2021-06-02,BARAS,13.6591045,124.3704682,0,0,2,-2,2
485,2021-06-03,BARAS,13.6591045,124.3704682,2,0,0,2,4
489,2021-06-04,BARAS,13.6591045,124.3704682,3,0,0,3,7
498,2021-06-07,BARAS,13.6591045,124.3704682,2,0,1,1,8
508,2021-06-09,BARAS,13.6591045,124.3704682,2,0,0,2,10
514,2021-06-10,BARAS,13.6591045,124.3704682,0,0,1,-1,9
520,2021-06-12,BARAS,13.6591045,124.3704682,0,0,4,-4,5
521,2021-06-13,BARAS,13.6591045,124.3704682,1,0,0,1,6
530,2021-06-15,BARAS,13.6591045,124.3704682,0,0,1,-1,5
536,2021-06-16,BARAS,13.6591045,124.3704682,0,0,2,-2,3
542,2021-06-17,BARAS,13.6591045,124.3704682,1,0,0,1,4
553,2021-06-21,BARAS,13.6591045,124.3704682,0,0,1,-1,3
558,2021-06-24,BARAS,13.6591045,124.3704682,1,0,0,1,4
571,2021-06-26,BARAS,13.6591045,124.3704682,0,0,1,-1,3
576,2021-06-27,BARAS,13.6591045,124.3704682,1,0,0,1,4
602,2021-07-03,BARAS,13.6591045,124.3704682,0,0,1,-1,3
623,2021-07-06,BARAS,13.6591045,124.3704682,0,0,1,-1,2
636,2021-07-08,BARAS,13.6591045,124.3704682,1,0,0,1,3
650,2021-07-10,BARAS,13.6591045,124.3704682,1,0,0,1,4
663,2021-07-11,BARAS,13.6591045,124.3704682,1,0,0,1,5
685,2021-07-15,BARAS,13.6591045,124.3704682,1,0,0,1,6
700,2021-07-17,BARAS,13.6591045,124.3704682,0,0,1,-1,5
714,2021-07-19,BARAS,13.6591045,124.3704682,0,0,1,-1,4
718,2021-07-20,BARAS,13.6591045,124.3704682,0,0,1,-1,3
744,2021-07-25,BARAS,13.6591045,124.3704682,0,0,1,-1,2
752,2021-07-26,BARAS,13.6591045,124.3704682,1,0,0,1,3
788,2021-08-04,BARAS,13.6591045,124.3704682,0,0,1,-1,2
852,2021-08-16,BARAS,13.6591045,124.3704682,2,0,0,2,4
872,2021-08-19,BARAS,13.6591045,124.3704682,2,0,0,2,6
874,2021-08-20,BARAS,13.6591045,124.3704682,1,0,0,1,7
887,2021-08-22,BARAS,13.6591045,124.3704682,1,0,0,1,8
899,2021-08-25,BARAS,13.6591045,124.3704682,0,0,2,-2,6
917,2021-08-28,BARAS,13.6591045,124.3704682,0,0,2,-2,4
921,2021-08-29,BARAS,13.6591045,124.3704682,0,0,1,-1,3
933,2021-08-31,BARAS,13.6591045,124.3704682,1,0,1,0,3
936,2021-09-01,BARAS,13.6591045,124.3704682,2,0,0,2,5
948,2021-09-03,BARAS,13.6591045,124.3704682,2,0,0,2,7
968,2021-09-06,BARAS,13.6591045,124.3704682,2,0,0,2,9
991,2021-09-09,BARAS,13.6591045,124.3704682,1,0,1,0,9
993,2021-09-10,BARAS,13.6591045,124.3704682,0,0,2,-2,7
995,2021-09-11,BARAS,13.6591045,124.3704682,1,0,0,1,8
1002,2021-09-12,BARAS,13.6591045,124.3704682,0,0,2,-2,6
1032,2021-09-15,BARAS,13.6591045,124.3704682,0,0,2,-2,4
1038,2021-09-16,BARAS,13.6591045,124.3704682,1,0,0,1,5
1046,2021-09-17,BARAS,13.6591045,124.3704682,1,0,0,1,6
1053,2021-09-18,BARAS,13.6591045,124.3704682,0,0,1,-1,5
1061,2021-09-19,BARAS,13.6591045,124.3704682,3,0,1,2,7
1095,2021-09-24,BARAS,13.6591045,124.3704682,3,0,0,3,10
1105,2021-09-25,BARAS,13.6591045,124.3704682,0,0,1,-1,9
1108,2021-09-26,BARAS,13.6591045,124.3704682,0,0,1,-1,8
1119,2021-09-27,BARAS,13.6591045,124.3704682,1,0,0,1,9
1123,2021-09-28,BARAS,13.6591045,124.3704682,0,0,3,-3,6
1159,2021-10-03,BARAS,13.6591045,124.3704682,0,0,4,-4,2
1175,2021-10-06,BARAS,13.6591045,124.3704682,1,0,0,1,3
1195,2021-10-09,BARAS,13.6591045,124.3704682,1,0,1,0,3
1203,2021-10-10,BARAS,13.6591045,124.3704682,4,0,0,4,7
1214,2021-10-11,BARAS,13.6591045,124.3704682,1,0,0,1,8
1218,2021-10-12,BARAS,13.6591045,124.3704682,1,0,0,1,9
1234,2021-10-15,BARAS,13.6591045,124.3704682,0,0,1,-1,8
1251,2021-10-17,BARAS,13.6591045,124.3704682,1,0,0,1,9
1260,2021-10-18,BARAS,13.6591045,124.3704682,0,0,4,-4,5
1277,2021-10-19,BARAS,13.6591045,124.3704682,0,0,1,-1,4
1288,2021-10-21,BARAS,13.6591045,124.3704682,0,0,1,-1,3
1297,2021-10-22,BARAS,13.6591045,124.3704682,1,0,0,1,4
1307,2021-10-23,BARAS,13.6591045,124.3704682,1,0,0,1,5
1334,2021-10-26,BARAS,13.6591045,124.3704682,0,0,1,-1,4
1354,2021-10-28,BARAS,13.6591045,124.3704682,4,0,0,4,8
1365,2021-10-30,BARAS,13.6591045,124.3704682,2,0,0,2,10
1376,2021-10-31,BARAS,13.6591045,124.3704682,1,0,1,0,10
1388,2021-11-01,BARAS,13.6591045,124.3704682,0,0,1,-1,9
1413,2021-11-05,BARAS,13.6591045,124.3704682,4,0,0,4,13
1423,2021-11-06,BARAS,13.6591045,124.3704682,3,0,4,-1,12
1438,2021-11-08,BARAS,13.6591045,124.3704682,1,0,2,-1,11
1453,2021-11-09,BARAS,13.6591045,124.3704682,0,0,1,-1,10
1465,2021-11-11,BARAS,13.6591045,124.3704682,1,0,0,1,11
1477,2021-11-12,BARAS,13.6591045,124.3704682,2,0,0,2,13
1493,2021-11-14,BARAS,13.6591045,124.3704682,0,0,4,-4,9
1498,2021-11-15,BARAS,13.6591045,124.3704682,0,0,3,-3,6
1516,2021-11-17,BARAS,13.6591045,124.3704682,0,0,1,-1,5
1523,2021-11-18,BARAS,13.6591045,124.3704682,2,0,0,2,7
1530,2021-11-19,BARAS,13.6591045,124.3704682,1,0,0,1,8
1538,2021-11-20,BARAS,13.6591045,124.3704682,0,0,1,-1,7
1553,2021-11-21,BARAS,13.6591045,124.3704682,0,0,2,-2,5
1589,2021-11-26,BARAS,13.6591045,124.3704682,1,0,0,1,6
1593,2021-11-27,BARAS,13.6591045,124.3704682,0,0,2,-2,4
1599,2021-11-28,BARAS,13.6591045,124.3704682,0,0,1,-1,3
1627,2021-12-06,BARAS,13.6591045,124.3704682,0,0,1,-1,2
1663,2022-01-06,BARAS,13.6591045,124.3704682,1,0,1,0,2
1671,2022-01-08,BARAS,13.6591045,124.3704682,2,0,0,2,4
1675,2022-01-09,BARAS,13.6591045,124.3704682,1,0,0,1,5
1683,2022-01-12,BARAS,13.6591045,124.3704682,2,0,0,2,7
1691,2022-01-13,BARAS,13.6591045,124.3704682,3,0,0,3,10
1696,2022-01-14,BARAS,13.6591045,124.3704682,1,0,0,1,11
1702,2022-01-15,BARAS,13.6591045,124.3704682,0,0,1,-1,10
1711,2022-01-16,BARAS,13.6591045,124.3704682,1,0,0,1,11
1723,2022-01-17,BARAS,13.6591045,124.3704682,1,0,0,1,12
1730,2022-01-18,BARAS,13.6591045,124.3704682,1,0,3,-2,10
1731,2022-01-19,BARAS,13.6591045,124.3704682,2,0,0,2,12
1741,2022-01-20,BARAS,13.6591045,124.3704682,0,0,2,-2,10
1758,2022-01-22,BARAS,13.6591045,124.3704682,1,0,3,-2,8
1767,2022-01-23,BARAS,13.6591045,124.3704682,0,0,1,-1,7
1785,2022-01-25,BARAS,13.6591045,124.3704682,0,0,1,-1,6
1797,2022-01-26,BARAS,13.6591045,124.3704682,1,0,2,-1,5
1810,2022-01-28,BARAS,13.6591045,124.3704682,1,0,0,1,6
1823,2022-01-29,BARAS,13.6591045,124.3704682,0,0,1,-1,5
1841,2022-01-31,BARAS,13.6591045,124.3704682,0,0,1,-1,4
1865,2022-02-04,BARAS,13.6591045,124.3704682,1,0,0,1,5
1877,2022-02-05,BARAS,13.6591045,124.3704682,0,0,1,-1,4
1896,2022-02-07,BARAS,13.6591045,124.3704682,0,0,1,-1,3
1916,2022-02-11,BARAS,13.6591045,124.3704682,1,0,0,1,4
1920,2022-02-12,BARAS,13.6591045,124.3704682,1,0,1,0,4
1941,2022-02-16,BARAS,13.6591045,124.3704682,1,0,0,1,5
1954,2022-02-21,BARAS,13.6591045,124.3704682,0,0,1,-1,4
1958,2022-02-22,BARAS,13.6591045,124.3704682,0,0,1,-1,3
1966,2022-02-26,BARAS,13.6591045,124.3704682,0,0,1,-1,2
1987,2022-03-13,BARAS,13.6591045,124.3704682,1,0,0,1,3
1992,2022-03-18,BARAS,13.6591045,124.3704682,1,0,0,1,4
1994,2022-03-20,BARAS,13.6591045,124.3704682,1,0,0,1,5
1995,2022-03-21,BARAS,13.6591045,124.3704682,0,0,1,-1,4
1999,2022-03-27,BARAS,13.6591045,124.3704682,0,0,1,-1,3
2000,2022-03-30,BARAS,13.6591045,124.3704682,0,0,1,-1,2
2009,2022-04-15,BARAS,13.6591045,124.3704682,0,0,1,-1,1
2043,2022-06-08,BARAS,13.6591045,124.3704682,1,0,0,1,2
2050,2022-06-18,BARAS,13.6591045,124.3704682,0,0,1,-1,1
2053,2022-06-24,BARAS,13.6591045,124.3704682,1,0,0,1,2
2066,2022-07-03,BARAS,13.6591045,124.3704682,0,0,1,-1,1
2071,2022-07-08,BARAS,13.6591045,124.3704682,1,0,0,1,2
2102,2022-07-18,BARAS,13.6591045,124.3704682,0,0,1,-1,1
2104,2022-07-19,BARAS,13.6591045,124.3704682,1,0,0,1,2
2107,2022-07-20,BARAS,13.6591045,124.3704682,2,0,0,2,4
2117,2022-07-23,BARAS,13.6591045,124.3704682,1,0,0,1,5
2137,2022-07-28,BARAS,13.6591045,124.3704682,1,0,0,1,6
2143,2022-07-30,BARAS,13.6591045,124.3704682,2,0,2,0,6
2145,2022-07-31,BARAS,13.6591045,124.3704682,1,0,1,0,6
2153,2022-08-02,BARAS,13.6591045,124.3704682,0,0,1,-1,5
2163,2022-08-04,BARAS,13.6591045,124.3704682,7,0,0,7,12
2171,2022-08-05,BARAS,13.6591045,124.3704682,1,0,0,1,13
2174,2022-08-06,BARAS,13.6591045,124.3704682,1,0,0,1,14
2177,2022-08-07,BARAS,13.6591045,124.3704682,1,0,1,0,14
2178,2022-08-08,BARAS,13.6591045,124.3704682,0,0,1,-1,13
2180,2022-08-09,BARAS,13.6591045,124.3704682,0,0,1,-1,12
2187,2022-08-10,BARAS,13.6591045,124.3704682,2,0,1,1,13
2199,2022-08-13,BARAS,13.6591045,124.3704682,0,0,4,-4,9
2203,2022-08-14,BARAS,13.6591045,124.3704682,0,0,4,-4,5
2214,2022-08-16,BARAS,13.6591045,124.3704682,0,0,1,-1,4
2220,2022-08-17,BARAS,13.6591045,124.3704682,2,0,1,1,5
2226,2022-08-20,BARAS,13.6591045,124.3704682,1,0,2,-1,4
2240,2022-08-22,BARAS,13.6591045,124.3704682,1,0,0,1,5
2246,2022-08-25,BARAS,13.6591045,124.3704682,1,0,0,1,6
2254,2022-08-27,BARAS,13.6591045,124.3704682,1,0,2,-1,5
2261,2022-08-29,BARAS,13.6591045,124.3704682,0,0,1,-1,4
2264,2022-08-31,BARAS,13.6591045,124.3704682,0,0,1,-1,3
2269,2022-09-02,BARAS,13.6591045,124.3704682,1,0,0,1,4
2273,2022-09-03,BARAS,13.6591045,124.3704682,0,0,1,-1,3
2284,2022-09-11,BARAS,13.6591045,124.3704682,0,0,1,-1,2
2325,2022-11-03,BARAS,13.6591045,124.3704682,0,1,0,-1,1
2340,2023-04-02,BARAS,13.6591045,124.3704682,1,0,0,1,2
2342,2023-04-12,BARAS,13.6591045,124.3704682,0,0,1,-1,1
2345,2023-04-20,BARAS,13.6591045,124.3704682,0,0,1,-1,0
2373,2023-05-14,BARAS,13.6591045,124.3704682,1,0,0,1,1
2386,2023-05-19,BARAS,13.6591045,124.3704682,1,0,0,1,2
2407,2023-05-23,BARAS,13.6591045,124.3704682,0,0,1,-1,1
2428,2023-05-28,BARAS,13.6591045,124.3704682,0,0,1,-1,0
2475,2023-06-07,BARAS,13.6591045,124.3704682,1,0,0,1,1
2482,2023-06-09,BARAS,13.6591045,124.3704682,1,0,0,1,2
2498,2023-06-16,BARAS,13.6591045,124.3704682,0,0,1,-1,1
2501,2023-06-17,BARAS,13.6591045,124.3704682,2,0,0,2,3
2504,2023-06-18,BARAS,13.6591045,124.3704682,0,0,1,-1,2
2508,2023-06-25,BARAS,13.6591045,124.3704682,0,0,2,-2,0
21,2020-08-09,PANDAN,14.0492274,124.1702111,1,0,0,1,1
43,2020-08-22,PANDAN,14.0492274,124.1702111,1,0,0,1,2
45,2020-08-23,PANDAN,14.0492274,124.1702111,0,0,1,-1,1
74,2020-09-13,PANDAN,14.0492274,124.1702111,0,0,1,-1,0
77,2020-09-15,PANDAN,14.0492274,124.1702111,2,0,0,2,2
86,2020-09-22,PANDAN,14.0492274,124.1702111,1,0,0,1,3
100,2020-10-04,PANDAN,14.0492274,124.1702111,0,0,2,-2,1
105,2020-10-11,PANDAN,14.0492274,124.1702111,0,0,1,-1,0
119,2020-10-23,PANDAN,14.0492274,124.1702111,1,0,0,1,1
136,2020-11-08,PANDAN,14.0492274,124.1702111,0,0,1,-1,0
194,2021-01-31,PANDAN,14.0492274,124.1702111,1,0,0,1,1
202,2021-02-07,PANDAN,14.0492274,124.1702111,1,0,0,1,2
210,2021-02-14,PANDAN,14.0492274,124.1702111,0,0,1,-1,1
222,2021-02-21,PANDAN,14.0492274,124.1702111,0,0,1,-1,0
228,2021-02-27,PANDAN,14.0492274,124.1702111,1,0,0,1,1
232,2021-02-28,PANDAN,14.0492274,124.1702111,1,0,0,1,2
237,2021-03-03,PANDAN,14.0492274,124.1702111,1,0,0,1,3
238,2021-03-04,PANDAN,14.0492274,124.1702111,2,0,0,2,5
251,2021-03-08,PANDAN,14.0492274,124.1702111,1,0,0,1,6
265,2021-03-21,PANDAN,14.0492274,124.1702111,0,0,3,-3,3
277,2021-03-28,PANDAN,14.0492274,124.1702111,0,0,1,-1,2
294,2021-04-07,PANDAN,14.0492274,124.1702111,0,1,0,-1,1
324,2021-04-19,PANDAN,14.0492274,124.1702111,1,0,0,1,2
346,2021-04-28,PANDAN,14.0492274,124.1702111,0,0,1,-1,1
367,2021-05-06,PANDAN,14.0492274,124.1702111,1,0,0,1,2
400,2021-05-15,PANDAN,14.0492274,124.1702111,0,0,1,-1,1
545,2021-06-19,PANDAN,14.0492274,124.1702111,2,0,0,2,3
569,2021-06-26,PANDAN,14.0492274,124.1702111,1,0,0,1,4
580,2021-06-28,PANDAN,14.0492274,124.1702111,1,0,1,0,4
588,2021-06-29,PANDAN,14.0492274,124.1702111,0,0,1,-1,3
594,2021-07-01,PANDAN,14.0492274,124.1702111,1,0,0,1,4
603,2021-07-03,PANDAN,14.0492274,124.1702111,1,0,0,1,5
616,2021-07-05,PANDAN,14.0492274,124.1702111,0,0,1,-1,4
632,2021-07-07,PANDAN,14.0492274,124.1702111,0,0,1,-1,3
639,2021-07-08,PANDAN,14.0492274,124.1702111,1,0,0,1,4
655,2021-07-10,PANDAN,14.0492274,124.1702111,0,0,1,-1,3
671,2021-07-12,PANDAN,14.0492274,124.1702111,0,0,1,-1,2
690,2021-07-16,PANDAN,14.0492274,124.1702111,1,0,0,1,3
695,2021-07-17,PANDAN,14.0492274,124.1702111,0,0,1,-1,2
730,2021-07-22,PANDAN,14.0492274,124.1702111,1,0,0,1,3
739,2021-07-25,PANDAN,14.0492274,124.1702111,0,0,1,-1,2
775,2021-07-31,PANDAN,14.0492274,124.1702111,1,0,1,0,2
777,2021-08-01,PANDAN,14.0492274,124.1702111,2,0,0,2,4
785,2021-08-03,PANDAN,14.0492274,124.1702111,1,0,0,1,5
801,2021-08-06,PANDAN,14.0492274,124.1702111,5,0,0,5,10
810,2021-08-08,PANDAN,14.0492274,124.1702111,1,0,0,1,11
820,2021-08-09,PANDAN,14.0492274,124.1702111,6,0,1,5,16
823,2021-08-10,PANDAN,14.0492274,124.1702111,0,0,2,-2,14
833,2021-08-13,PANDAN,14.0492274,124.1702111,2,0,1,1,15
844,2021-08-15,PANDAN,14.0492274,124.1702111,1,0,5,-4,11
850,2021-08-16,PANDAN,14.0492274,124.1702111,6,0,0,6,17
857,2021-08-17,PANDAN,14.0492274,124.1702111,0,0,1,-1,16
865,2021-08-18,PANDAN,14.0492274,124.1702111,0,0,6,-6,10
866,2021-08-19,PANDAN,14.0492274,124.1702111,7,0,0,7,17
880,2021-08-21,PANDAN,14.0492274,124.1702111,0,0,2,-2,15
886,2021-08-22,PANDAN,14.0492274,124.1702111,2,0,0,2,17
895,2021-08-24,PANDAN,14.0492274,124.1702111,0,0,1,-1,16
902,2021-08-25,PANDAN,14.0492274,124.1702111,0,0,6,-6,10
911,2021-08-28,PANDAN,14.0492274,124.1702111,2,0,7,-5,5
931,2021-08-31,PANDAN,14.0492274,124.1702111,2,0,2,0,5
941,2021-09-02,PANDAN,14.0492274,124.1702111,1,0,0,1,6
944,2021-09-03,PANDAN,14.0492274,124.1702111,3,0,0,3,9
966,2021-09-06,PANDAN,14.0492274,124.1702111,1,0,2,-1,8
992,2021-09-09,PANDAN,14.0492274,124.1702111,2,0,2,0,8
994,2021-09-10,PANDAN,14.0492274,124.1702111,0,0,1,-1,7
1001,2021-09-12,PANDAN,14.0492274,124.1702111,0,0,3,-3,4
1016,2021-09-13,PANDAN,14.0492274,124.1702111,1,0,0,1,5
1023,2021-09-15,PANDAN,14.0492274,124.1702111,0,0,1,-1,4
1041,2021-09-16,PANDAN,14.0492274,124.1702111,1,0,0,1,5
1044,2021-09-17,PANDAN,14.0492274,124.1702111,1,0,0,1,6
1055,2021-09-18,PANDAN,14.0492274,124.1702111,1,0,2,-1,5
1082,2021-09-22,PANDAN,14.0492274,124.1702111,0,0,1,-1,4
1106,2021-09-26,PANDAN,14.0492274,124.1702111,1,0,1,0,4
1117,2021-09-27,PANDAN,14.0492274,124.1702111,0,0,1,-1,3
1129,2021-09-28,PANDAN,14.0492274,124.1702111,0,0,1,-1,2
1141,2021-10-01,PANDAN,14.0492274,124.1702111,6,0,0,6,8
1151,2021-10-02,PANDAN,14.0492274,124.1702111,3,0,0,3,11
1156,2021-10-03,PANDAN,14.0492274,124.1702111,0,0,1,-1,10
1165,2021-10-05,PANDAN,14.0492274,124.1702111,11,0,0,11,21
1170,2021-10-06,PANDAN,14.0492274,124.1702111,3,0,0,3,24
1189,2021-10-09,PANDAN,14.0492274,124.1702111,4,0,0,4,28
1205,2021-10-10,PANDAN,14.0492274,124.1702111,0,0,7,-7,21
1215,2021-10-11,PANDAN,14.0492274,124.1702111,2,0,0,2,23
1221,2021-10-12,PANDAN,14.0492274,124.1702111,0,0,11,-11,12
1228,2021-10-13,PANDAN,14.0492274,124.1702111,5,0,0,5,17
1231,2021-10-14,PANDAN,14.0492274,124.1702111,0,0,3,-3,14
1233,2021-10-15,PANDAN,14.0492274,124.1702111,3,0,0,3,17
1244,2021-10-16,PANDAN,14.0492274,124.1702111,2,0,1,1,18
1250,2021-10-17,PANDAN,14.0492274,124.1702111,1,0,3,-2,16
1268,2021-10-18,PANDAN,14.0492274,124.1702111,3,0,2,1,17
1273,2021-10-19,PANDAN,14.0492274,124.1702111,0,0,1,-1,16
1284,2021-10-20,PANDAN,14.0492274,124.1702111,6,0,0,6,22
1290,2021-10-21,PANDAN,14.0492274,124.1702111,2,0,0,2,24
1303,2021-10-22,PANDAN,14.0492274,124.1702111,3,0,4,-1,23
1305,2021-10-23,PANDAN,14.0492274,124.1702111,16,0,4,12,35
1320,2021-10-24,PANDAN,14.0492274,124.1702111,0,0,1,-1,34
1329,2021-10-25,PANDAN,14.0492274,124.1702111,1,0,2,-1,33
1337,2021-10-26,PANDAN,14.0492274,124.1702111,0,0,2,-2,31
1350,2021-10-28,PANDAN,14.0492274,124.1702111,2,0,0,2,33
1358,2021-10-29,PANDAN,14.0492274,124.1702111,0,0,8,-8,25
1369,2021-10-30,PANDAN,14.0492274,124.1702111,3,1,1,1,26
1375,2021-10-31,PANDAN,14.0492274,124.1702111,0,0,17,-17,9
1394,2021-11-02,PANDAN,14.0492274,124.1702111,7,0,1,6,15
1404,2021-11-03,PANDAN,14.0492274,124.1702111,1,0,0,1,16
1409,2021-11-04,PANDAN,14.0492274,124.1702111,0,0,1,-1,15
1412,2021-11-05,PANDAN,14.0492274,124.1702111,2,0,2,0,15
1424,2021-11-06,PANDAN,14.0492274,124.1702111,1,0,0,1,16
1433,2021-11-07,PANDAN,14.0492274,124.1702111,2,0,3,-1,15
1443,2021-11-08,PANDAN,14.0492274,124.1702111,1,0,0,1,16
1458,2021-11-10,PANDAN,14.0492274,124.1702111,0,0,9,-9,7
1470,2021-11-11,PANDAN,14.0492274,124.1702111,5,0,0,5,12
1479,2021-11-13,PANDAN,14.0492274,124.1702111,1,0,1,0,12
1489,2021-11-14,PANDAN,14.0492274,124.1702111,1,0,3,-2,10
1500,2021-11-15,PANDAN,14.0492274,124.1702111,3,0,0,3,13
1511,2021-11-16,PANDAN,14.0492274,124.1702111,0,0,1,-1,12
1517,2021-11-17,PANDAN,14.0492274,124.1702111,0,0,1,-1,11
1525,2021-11-18,PANDAN,14.0492274,124.1702111,3,0,1,2,13
1534,2021-11-19,PANDAN,14.0492274,124.1702111,1,0,3,-2,11
1543,2021-11-20,PANDAN,14.0492274,124.1702111,1,0,1,0,11
1550,2021-11-21,PANDAN,14.0492274,124.1702111,1,0,1,0,11
1561,2021-11-22,PANDAN,14.0492274,124.1702111,2,0,2,0,11
1564,2021-11-23,PANDAN,14.0492274,124.1702111,0,0,3,-3,8
1580,2021-11-25,PANDAN,14.0492274,124.1702111,0,0,1,-1,7
1582,2021-11-26,PANDAN,14.0492274,124.1702111,3,0,0,3,10
1591,2021-11-27,PANDAN,14.0492274,124.1702111,0,0,2,-2,8
1598,2021-11-28,PANDAN,14.0492274,124.1702111,0,0,1,-1,7
1612,2021-11-30,PANDAN,14.0492274,124.1702111,0,0,3,-3,4
1625,2021-12-05,PANDAN,14.0492274,124.1702111,1,0,3,-2,2
1634,2021-12-08,PANDAN,14.0492274,124.1702111,1,0,0,1,3
1644,2021-12-15,PANDAN,14.0492274,124.1702111,0,0,1,-1,2
1646,2021-12-18,PANDAN,14.0492274,124.1702111,0,0,1,-1,1
1672,2022-01-08,PANDAN,14.0492274,124.1702111,1,1,0,0,1
1687,2022-01-13,PANDAN,14.0492274,124.1702111,3,0,0,3,4
1699,2022-01-15,PANDAN,14.0492274,124.1702111,2,0,0,2,6
1720,2022-01-17,PANDAN,14.0492274,124.1702111,0,0,1,-1,5
1735,2022-01-19,PANDAN,14.0492274,124.1702111,1,0,0,1,6
1739,2022-01-20,PANDAN,14.0492274,124.1702111,1,0,0,1,7
1748,2022-01-21,PANDAN,14.0492274,124.1702111,5,0,1,4,11
1755,2022-01-22,PANDAN,14.0492274,124.1702111,0,0,2,-2,9
1771,2022-01-23,PANDAN,14.0492274,124.1702111,1,0,2,-1,8
1783,2022-01-25,PANDAN,14.0492274,124.1702111,2,0,0,2,10
1792,2022-01-26,PANDAN,14.0492274,124.1702111,1,0,1,0,10
1816,2022-01-28,PANDAN,14.0492274,124.1702111,1,0,3,-2,8
1820,2022-01-29,PANDAN,14.0492274,124.1702111,0,0,2,-2,6
1845,2022-02-01,PANDAN,14.0492274,124.1702111,0,0,1,-1,5
1858,2022-02-02,PANDAN,14.0492274,124.1702111,0,0,1,-1,4
1870,2022-02-04,PANDAN,14.0492274,124.1702111,0,0,1,-1,3
1878,2022-02-05,PANDAN,14.0492274,124.1702111,0,0,1,-1,2
1888,2022-02-06,PANDAN,14.0492274,124.1702111,0,0,1,-1,1
1905,2022-02-09,PANDAN,14.0492274,124.1702111,1,0,0,1,2
1924,2022-02-13,PANDAN,14.0492274,124.1702111,1,0,0,1,3
1943,2022-02-18,PANDAN,14.0492274,124.1702111,0,0,1,-1,2
1957,2022-02-22,PANDAN,14.0492274,124.1702111,0,0,1,-1,1
1962,2022-02-25,PANDAN,14.0492274,124.1702111,1,0,0,1,2
1980,2022-03-06,PANDAN,14.0492274,124.1702111,0,0,1,-1,1
2195,2022-08-13,PANDAN,14.0492274,124.1702111,1,0,0,1,2
2216,2022-08-17,PANDAN,14.0492274,124.1702111,1,0,0,1,3
2224,2022-08-19,PANDAN,14.0492274,124.1702111,2,0,0,2,5
2231,2022-08-20,PANDAN,14.0492274,124.1702111,2,0,0,2,7
2236,2022-08-21,PANDAN,14.0492274,124.1702111,3,0,0,3,10
2241,2022-08-23,PANDAN,14.0492274,124.1702111,0,0,1,-1,9
2249,2022-08-26,PANDAN,14.0492274,124.1702111,1,0,1,0,9
2255,2022-08-27,PANDAN,14.0492274,124.1702111,0,0,1,-1,8
2258,2022-08-28,PANDAN,14.0492274,124.1702111,0,0,1,-1,7
2259,2022-08-29,PANDAN,14.0492274,124.1702111,0,0,2,-2,5
2262,2022-08-31,PANDAN,14.0492274,124.1702111,0,0,3,-3,2
2267,2022-09-01,PANDAN,14.0492274,124.1702111,0,1,0,-1,1
2270,2022-09-02,PANDAN,14.0492274,124.1702111,3,0,1,2,3
2282,2022-09-11,PANDAN,14.0492274,124.1702111,0,0,3,-3,0
2387,2023-05-19,PANDAN,14.0492274,124.1702111,1,0,0,1,1
2411,2023-05-24,PANDAN,14.0492274,124.1702111,1,0,0,1,2
2420,2023-05-27,PANDAN,14.0492274,124.1702111,1,0,0,1,3
2429,2023-05-28,PANDAN,14.0492274,124.1702111,0,0,1,-1,2
2448,2023-06-01,PANDAN,14.0492274,124.1702111,0,0,1,-1,1
2449,2023-06-02,PANDAN,14.0492274,124.1702111,0,0,1,-1,0
2458,2023-06-03,PANDAN,14.0492274,124.1702111,5,0,0,5,5
2474,2023-06-07,PANDAN,14.0492274,124.1702111,2,0,0,2,7
2480,2023-06-09,PANDAN,14.0492274,124.1702111,0,0,5,-5,2
2493,2023-06-14,PANDAN,14.0492274,124.1702111,0,0,1,-1,1
2495,2023-06-15,PANDAN,14.0492274,124.1702111,0,0,1,-1,0
2545,2023-12-01,PANDAN,14.0492274,124.1702111,1,0,0,1,1
2548,2023-12-07,PANDAN,14.0492274,124.1702111,1,0,1,0,1
2553,2023-12-14,PANDAN,14.0492274,124.1702111,1,0,0,1,2
2556,2023-12-15,PANDAN,14.0492274,124.1702111,0,0,1,-1,1
2561,2023-12-23,PANDAN,14.0492274,124.1702111,0,0,1,-1,0
22,2020-08-09,PANGANIBAN,13.9081674,124.30082,2,0,0,2,2
36,2020-08-16,PANGANIBAN,13.9081674,124.30082,0,0,1,-1,1
40,2020-08-21,PANGANIBAN,13.9081674,124.30082,1,0,0,1,2
41,2020-08-22,PANGANIBAN,13.9081674,124.30082,1,0,0,1,3
47,2020-08-25,PANGANIBAN,13.9081674,124.30082,0,0,1,-1,2
63,2020-09-06,PANGANIBAN,13.9081674,124.30082,0,0,1,-1,1
72,2020-09-13,PANGANIBAN,13.9081674,124.30082,0,0,1,-1,0
95,2020-09-29,PANGANIBAN,13.9081674,124.30082,1,0,0,1,1
97,2020-10-04,PANGANIBAN,13.9081674,124.30082,2,0,0,2,3
102,2020-10-08,PANGANIBAN,13.9081674,124.30082,1,0,0,1,4
112,2020-10-18,PANGANIBAN,13.9081674,124.30082,0,0,1,-1,3
123,2020-10-25,PANGANIBAN,13.9081674,124.30082,0,0,2,-2,1
132,2020-11-01,PANGANIBAN,13.9081674,124.30082,0,0,1,-1,0
212,2021-02-15,PANGANIBAN,13.9081674,124.30082,1,0,0,1,1
247,2021-03-07,PANGANIBAN,13.9081674,124.30082,0,0,1,-1,0
262,2021-03-19,PANGANIBAN,13.9081674,124.30082,1,0,0,1,1
288,2021-04-04,PANGANIBAN,13.9081674,124.30082,0,0,1,-1,0
311,2021-04-15,PANGANIBAN,13.9081674,124.30082,1,0,0,1,1
335,2021-04-24,PANGANIBAN,13.9081674,124.30082,0,0,1,-1,0
357,2021-05-02,PANGANIBAN,13.9081674,124.30082,4,0,0,4,4
360,2021-05-04,PANGANIBAN,13.9081674,124.30082,1,0,0,1,5
366,2021-05-06,PANGANIBAN,13.9081674,124.30082,6,0,0,6,11
377,2021-05-09,PANGANIBAN,13.9081674,124.30082,7,0,0,7,18
382,2021-05-10,PANGANIBAN,13.9081674,124.30082,0,0,4,-4,14
388,2021-05-11,PANGANIBAN,13.9081674,124.30082,1,0,0,1,15
392,2021-05-12,PANGANIBAN,13.9081674,124.30082,0,0,1,-1,14
402,2021-05-15,PANGANIBAN,13.9081674,124.30082,0,0,6,-6,8
409,2021-05-17,PANGANIBAN,13.9081674,124.30082,0,0,7,-7,1
418,2021-05-19,PANGANIBAN,13.9081674,124.30082,0,0,1,-1,0
468,2021-05-31,PANGANIBAN,13.9081674,124.30082,2,0,0,2,2
504,2021-06-07,PANGANIBAN,13.9081674,124.30082,2,0,0,2,4
506,2021-06-09,PANGANIBAN,13.9081674,124.30082,0,0,2,-2,2
525,2021-06-15,PANGANIBAN,13.9081674,124.30082,0,0,2,-2,0
546,2021-06-19,PANGANIBAN,13.9081674,124.30082,3,0,0,3,3
561,2021-06-24,PANGANIBAN,13.9081674,124.30082,3,0,0,3,6
582,2021-06-28,PANGANIBAN,13.9081674,124.30082,0,0,3,-3,3
598,2021-07-01,PANGANIBAN,13.9081674,124.30082,1,0,0,1,4
607,2021-07-03,PANGANIBAN,13.9081674,124.30082,0,0,3,-3,1
633,2021-07-07,PANGANIBAN,13.9081674,124.30082,1,0,0,1,2
638,2021-07-08,PANGANIBAN,13.9081674,124.30082,2,0,0,2,4
647,2021-07-09,PANGANIBAN,13.9081674,124.30082,1,0,0,1,5
654,2021-07-10,PANGANIBAN,13.9081674,124.30082,1,0,1,0,5
660,2021-07-11,PANGANIBAN,13.9081674,124.30082,2,0,0,2,7
672,2021-07-12,PANGANIBAN,13.9081674,124.30082,3,0,0,3,10
682,2021-07-15,PANGANIBAN,13.9081674,124.30082,6,0,0,6,16
691,2021-07-16,PANGANIBAN,13.9081674,124.30082,2,0,0,2,18
696,2021-07-17,PANGANIBAN,13.9081674,124.30082,0,0,3,-3,15
702,2021-07-18,PANGANIBAN,13.9081674,124.30082,0,0,1,-1,14
712,2021-07-19,PANGANIBAN,13.9081674,124.30082,3,0,1,2,16
717,2021-07-20,PANGANIBAN,13.9081674,124.30082,0,0,2,-2,14
725,2021-07-21,PANGANIBAN,13.9081674,124.30082,0,0,3,-3,11
732,2021-07-22,PANGANIBAN,13.9081674,124.30082,1,0,0,1,12
738,2021-07-24,PANGANIBAN,13.9081674,124.30082,0,0,7,-7,5
741,2021-07-25,PANGANIBAN,13.9081674,124.30082,1,0,1,0,5
750,2021-07-26,PANGANIBAN,13.9081674,124.30082,1,0,0,1,6
758,2021-07-28,PANGANIBAN,13.9081674,124.30082,0,0,3,-3,3
759,2021-07-29,PANGANIBAN,13.9081674,124.30082,4,0,0,4,7
773,2021-07-31,PANGANIBAN,13.9081674,124.30082,0,0,1,-1,6
792,2021-08-04,PANGANIBAN,13.9081674,124.30082,1,0,1,0,6
805,2021-08-07,PANGANIBAN,13.9081674,124.30082,0,0,4,-4,2
842,2021-08-14,PANGANIBAN,13.9081674,124.30082,0,0,1,-1,1
951,2021-09-03,PANGANIBAN,13.9081674,124.30082,1,0,0,1,2
965,2021-09-06,PANGANIBAN,13.9081674,124.30082,1,0,0,1,3
987,2021-09-09,PANGANIBAN,13.9081674,124.30082,1,0,0,1,4
1009,2021-09-12,PANGANIBAN,13.9081674,124.30082,4,0,1,3,7
1026,2021-09-15,PANGANIBAN,13.9081674,124.30082,0,0,1,-1,6
1039,2021-09-16,PANGANIBAN,13.9081674,124.30082,2,0,0,2,8
1048,2021-09-18,PANGANIBAN,13.9081674,124.30082,0,0,1,-1,7
1059,2021-09-19,PANGANIBAN,13.9081674,124.30082,4,0,0,4,11
1077,2021-09-21,PANGANIBAN,13.9081674,124.30082,0,0,4,-4,7
1097,2021-09-25,PANGANIBAN,13.9081674,124.30082,0,0,2,-2,5
1127,2021-09-28,PANGANIBAN,13.9081674,124.30082,0,0,4,-4,1
1134,2021-09-30,PANGANIBAN,13.9081674,124.30082,1,0,0,1,2
1187,2021-10-09,PANGANIBAN,13.9081674,124.30082,0,0,1,-1,1
1207,2021-10-11,PANGANIBAN,13.9081674,124.30082,1,0,0,1,2
1242,2021-10-15,PANGANIBAN,13.9081674,124.30082,4,0,0,4,6
1254,2021-10-17,PANGANIBAN,13.9081674,124.30082,2,0,0,2,8
1279,2021-10-19,PANGANIBAN,13.9081674,124.30082,0,0,1,-1,7
1285,2021-10-20,PANGANIBAN,13.9081674,124.30082,1,0,0,1,8
1322,2021-10-24,PANGANIBAN,13.9081674,124.30082,0,0,4,-4,4
1330,2021-10-25,PANGANIBAN,13.9081674,124.30082,2,0,0,2,6
1336,2021-10-26,PANGANIBAN,13.9081674,124.30082,0,0,2,-2,4
1368,2021-10-30,PANGANIBAN,13.9081674,124.30082,8,0,1,7,11
1379,2021-10-31,PANGANIBAN,13.9081674,124.30082,1,0,0,1,12
1396,2021-11-02,PANGANIBAN,13.9081674,124.30082,1,0,1,0,12
1405,2021-11-03,PANGANIBAN,13.9081674,124.30082,0,0,1,-1,11
1417,2021-11-05,PANGANIBAN,13.9081674,124.30082,3,0,0,3,14
1430,2021-11-07,PANGANIBAN,13.9081674,124.30082,0,0,1,-1,13
1446,2021-11-08,PANGANIBAN,13.9081674,124.30082,0,0,8,-8,5
1463,2021-11-11,PANGANIBAN,13.9081674,124.30082,0,0,1,-1,4
1471,2021-11-12,PANGANIBAN,13.9081674,124.30082,3,0,0,3,7
1481,2021-11-13,PANGANIBAN,13.9081674,124.30082,1,0,0,1,8
1492,2021-11-14,PANGANIBAN,13.9081674,124.30082,2,0,3,-1,7
1504,2021-11-15,PANGANIBAN,13.9081674,124.30082,1,0,0,1,8
1527,2021-11-18,PANGANIBAN,13.9081674,124.30082,4,0,0,4,12
1537,2021-11-20,PANGANIBAN,13.9081674,124.30082,5,0,0,5,17
1554,2021-11-21,PANGANIBAN,13.9081674,124.30082,0,0,3,-3,14
1562,2021-11-22,PANGANIBAN,13.9081674,124.30082,0,0,1,-1,13
1570,2021-11-23,PANGANIBAN,13.9081674,124.30082,0,0,1,-1,12
1572,2021-11-24,PANGANIBAN,13.9081674,124.30082,0,0,1,-1,11
1575,2021-11-25,PANGANIBAN,13.9081674,124.30082,0,0,1,-1,10
1585,2021-11-26,PANGANIBAN,13.9081674,124.30082,0,0,1,-1,9
1592,2021-11-27,PANGANIBAN,13.9081674,124.30082,0,0,3,-3,6
1607,2021-11-29,PANGANIBAN,13.9081674,124.30082,0,0,5,-5,1
1650,2021-12-23,PANGANIBAN,13.9081674,124.30082,1,0,0,1,2
1657,2022-01-01,PANGANIBAN,13.9081674,124.30082,0,0,1,-1,1
1677,2022-01-09,PANGANIBAN,13.9081674,124.30082,1,0,0,1,2
1678,2022-01-10,PANGANIBAN,13.9081674,124.30082,2,0,0,2,4
1688,2022-01-13,PANGANIBAN,13.9081674,124.30082,4,0,0,4,8
1707,2022-01-16,PANGANIBAN,13.9081674,124.30082,1,0,1,0,8
1724,2022-01-17,PANGANIBAN,13.9081674,124.30082,3,0,0,3,11
1728,2022-01-18,PANGANIBAN,13.9081674,124.30082,0,0,1,-1,10
1732,2022-01-19,PANGANIBAN,13.9081674,124.30082,0,0,1,-1,9
1756,2022-01-22,PANGANIBAN,13.9081674,124.30082,0,0,4,-4,5
1773,2022-01-23,PANGANIBAN,13.9081674,124.30082,2,0,0,2,7
1786,2022-01-25,PANGANIBAN,13.9081674,124.30082,0,0,1,-1,6
1798,2022-01-26,PANGANIBAN,13.9081674,124.30082,3,0,2,1,7
1803,2022-01-27,PANGANIBAN,13.9081674,124.30082,4,0,0,4,11
1827,2022-01-29,PANGANIBAN,13.9081674,124.30082,3,0,0,3,14
1831,2022-01-30,PANGANIBAN,13.9081674,124.30082,2,0,0,2,16
1843,2022-02-01,PANGANIBAN,13.9081674,124.30082,1,0,2,-1,15
1852,2022-02-02,PANGANIBAN,13.9081674,124.30082,2,0,0,2,17
1879,2022-02-05,PANGANIBAN,13.9081674,124.30082,0,0,4,-4,13
1882,2022-02-06,PANGANIBAN,13.9081674,124.30082,0,0,3,-3,10
1899,2022-02-08,PANGANIBAN,13.9081674,124.30082,0,0,3,-3,7
1910,2022-02-09,PANGANIBAN,13.9081674,124.30082,0,0,2,-2,5
1917,2022-02-11,PANGANIBAN,13.9081674,124.30082,0,0,1,-1,4
1923,2022-02-12,PANGANIBAN,13.9081674,124.30082,0,0,2,-2,2
1937,2022-02-16,PANGANIBAN,13.9081674,124.30082,2,0,0,2,4
1968,2022-02-26,PANGANIBAN,13.9081674,124.30082,0,0,2,-2,2
1981,2022-03-06,PANGANIBAN,13.9081674,124.30082,0,0,1,-1,1
2003,2022-04-11,PANGANIBAN,13.9081674,124.30082,0,0,1,-1,0
2098,2022-07-17,PANGANIBAN,13.9081674,124.30082,1,0,0,1,1
2132,2022-07-27,PANGANIBAN,13.9081674,124.30082,0,0,1,-1,0
2443,2023-05-31,PANGANIBAN,13.9081674,124.30082,3,0,0,3,3
2472,2023-06-07,PANGANIBAN,13.9081674,124.30082,0,0,1,-1,2
2481,2023-06-09,PANGANIBAN,13.9081674,124.30082,0,0,1,-1,1
2525,2023-08-04,PANGANIBAN,13.9081674,124.30082,0,0,1,-1,0
28,2020-08-14,BATO,13.6080363,124.2977872,1,0,0,1,1
30,2020-08-15,BATO,13.6080363,124.2977872,1,0,0,1,2
38,2020-08-21,BATO,13.6080363,124.2977872,1,0,0,1,3
53,2020-08-30,BATO,13.6080363,124.2977872,2,0,1,1,4
62,2020-09-06,BATO,13.6080363,124.2977872,0,0,1,-1,3
69,2020-09-12,BATO,13.6080363,124.2977872,1,0,0,1,4
73,2020-09-13,BATO,13.6080363,124.2977872,0,0,1,-1,3
83,2020-09-20,BATO,13.6080363,124.2977872,0,0,2,-2,1
93,2020-09-27,BATO,13.6080363,124.2977872,0,0,1,-1,0
113,2020-10-19,BATO,13.6080363,124.2977872,1,0,0,1,1
127,2020-10-28,BATO,13.6080363,124.2977872,1,0,0,1,2
128,2020-11-01,BATO,13.6080363,124.2977872,0,0,1,-1,1
141,2020-11-15,BATO,13.6080363,124.2977872,0,0,1,-1,0
156,2020-12-14,BATO,13.6080363,124.2977872,1,0,0,1,1
162,2020-12-22,BATO,13.6080363,124.2977872,1,0,0,1,2
166,2020-12-25,BATO,13.6080363,124.2977872,1,0,0,1,3
168,2021-01-01,BATO,13.6080363,124.2977872,1,0,0,1,4
172,2021-01-03,BATO,13.6080363,124.2977872,0,0,1,-1,3
173,2021-01-10,BATO,13.6080363,124.2977872,0,0,3,-3,0
178,2021-01-14,BATO,13.6080363,124.2977872,3,0,0,3,3
185,2021-01-22,BATO,13.6080363,124.2977872,1,0,0,1,4
188,2021-01-24,BATO,13.6080363,124.2977872,0,0,3,-3,1
192,2021-01-28,BATO,13.6080363,124.2977872,1,0,0,1,2
199,2021-02-02,BATO,13.6080363,124.2977872,1,0,0,1,3
203,2021-02-07,BATO,13.6080363,124.2977872,1,0,1,0,3
208,2021-02-14,BATO,13.6080363,124.2977872,0,0,1,-1,2
223,2021-02-21,BATO,13.6080363,124.2977872,0,0,2,-2,0
241,2021-03-06,BATO,13.6080363,124.2977872,1,0,0,1,1
252,2021-03-10,BATO,13.6080363,124.2977872,1,0,0,1,2
254,2021-03-13,BATO,13.6080363,124.2977872,1,0,0,1,3
269,2021-03-23,BATO,13.6080363,124.2977872,1,0,0,1,4
271,2021-03-25,BATO,13.6080363,124.2977872,1,0,0,1,5
276,2021-03-28,BATO,13.6080363,124.2977872,0,0,2,-2,3
306,2021-04-11,BATO,13.6080363,124.2977872,1,0,1,0,3
315,2021-04-18,BATO,13.6080363,124.2977872,0,0,1,-1,2
319,2021-04-19,BATO,13.6080363,124.2977872,1,0,0,1,3
336,2021-04-25,BATO,13.6080363,124.2977872,0,0,1,-1,2
345,2021-04-28,BATO,13.6080363,124.2977872,0,0,1,-1,1
373,2021-05-07,BATO,13.6080363,124.2977872,1,0,0,1,2
386,2021-05-11,BATO,13.6080363,124.2977872,2,0,0,2,4
398,2021-05-13,BATO,13.6080363,124.2977872,2,0,0,2,6
404,2021-05-15,BATO,13.6080363,124.2977872,0,0,1,-1,5
415,2021-05-17,BATO,13.6080363,124.2977872,1,0,0,1,6
416,2021-05-18,BATO,13.6080363,124.2977872,1,0,0,1,7
421,2021-05-19,BATO,13.6080363,124.2977872,0,0,2,-2,5
433,2021-05-22,BATO,13.6080363,124.2977872,0,0,2,-2,3
435,2021-05-24,BATO,13.6080363,124.2977872,1,0,0,1,4
443,2021-05-25,BATO,13.6080363,124.2977872,2,0,0,2,6
448,2021-05-26,BATO,13.6080363,124.2977872,1,0,2,-1,5
463,2021-05-29,BATO,13.6080363,124.2977872,2,0,0,2,7
472,2021-05-31,BATO,13.6080363,124.2977872,2,0,1,1,8
477,2021-06-01,BATO,13.6080363,124.2977872,0,0,1,-1,7
482,2021-06-02,BATO,13.6080363,124.2977872,1,0,2,-1,6
486,2021-06-03,BATO,13.6080363,124.2977872,2,0,0,2,8
490,2021-06-04,BATO,13.6080363,124.2977872,1,0,0,1,9
500,2021-06-07,BATO,13.6080363,124.2977872,1,0,2,-1,8
509,2021-06-09,BATO,13.6080363,124.2977872,1,0,2,-1,7
516,2021-06-12,BATO,13.6080363,124.2977872,0,0,4,-4,3
526,2021-06-15,BATO,13.6080363,124.2977872,1,0,1,0,3
532,2021-06-16,BATO,13.6080363,124.2977872,0,0,1,-1,2
539,2021-06-17,BATO,13.6080363,124.2977872,1,0,0,1,3
548,2021-06-21,BATO,13.6080363,124.2977872,4,0,0,4,7
557,2021-06-23,BATO,13.6080363,124.2977872,0,0,1,-1,6
570,2021-06-26,BATO,13.6080363,124.2977872,1,0,1,0,6
593,2021-06-30,BATO,13.6080363,124.2977872,0,0,4,-4,2
595,2021-07-01,BATO,13.6080363,124.2977872,1,0,0,1,3
622,2021-07-05,BATO,13.6080363,124.2977872,2,0,1,1,4
640,2021-07-08,BATO,13.6080363,124.2977872,1,0,0,1,5
645,2021-07-09,BATO,13.6080363,124.2977872,1,0,0,1,6
651,2021-07-10,BATO,13.6080363,124.2977872,0,0,1,-1,5
662,2021-07-11,BATO,13.6080363,124.2977872,1,0,0,1,6
666,2021-07-12,BATO,13.6080363,124.2977872,1,0,0,1,7
679,2021-07-14,BATO,13.6080363,124.2977872,0,0,2,-2,5
701,2021-07-17,BATO,13.6080363,124.2977872,0,0,1,-1,4
703,2021-07-18,BATO,13.6080363,124.2977872,0,0,1,-1,3
721,2021-07-21,BATO,13.6080363,124.2977872,0,0,2,-2,1
729,2021-07-22,BATO,13.6080363,124.2977872,1,0,0,1,2
751,2021-07-26,BATO,13.6080363,124.2977872,2,0,0,2,4
766,2021-07-30,BATO,13.6080363,124.2977872,1,0,0,1,5
771,2021-07-31,BATO,13.6080363,124.2977872,1,0,1,0,5
790,2021-08-04,BATO,13.6080363,124.2977872,0,0,2,-2,3
799,2021-08-05,BATO,13.6080363,124.2977872,2,0,0,2,5
807,2021-08-07,BATO,13.6080363,124.2977872,1,0,0,1,6
812,2021-08-08,BATO,13.6080363,124.2977872,0,0,1,-1,5
816,2021-08-09,BATO,13.6080363,124.2977872,4,0,1,3,8
828,2021-08-12,BATO,13.6080363,124.2977872,1,0,0,1,9
841,2021-08-14,BATO,13.6080363,124.2977872,8,0,2,6,15
854,2021-08-16,BATO,13.6080363,124.2977872,1,0,1,0,15
862,2021-08-18,BATO,13.6080363,124.2977872,0,0,4,-4,11
878,2021-08-21,BATO,13.6080363,124.2977872,0,0,1,-1,10
892,2021-08-23,BATO,13.6080363,124.2977872,0,0,8,-8,2
896,2021-08-24,BATO,13.6080363,124.2977872,0,0,1,-1,1
905,2021-08-26,BATO,13.6080363,124.2977872,1,0,0,1,2
919,2021-08-28,BATO,13.6080363,124.2977872,5,0,0,5,7
923,2021-08-29,BATO,13.6080363,124.2977872,1,0,0,1,8
926,2021-08-30,BATO,13.6080363,124.2977872,1,0,0,1,9
943,2021-09-03,BATO,13.6080363,124.2977872,5,0,0,5,14
953,2021-09-04,BATO,13.6080363,124.2977872,2,0,1,1,15
961,2021-09-05,BATO,13.6080363,124.2977872,3,0,0,3,18
967,2021-09-06,BATO,13.6080363,124.2977872,0,0,5,-5,13
978,2021-09-07,BATO,13.6080363,124.2977872,1,0,0,1,14
982,2021-09-08,BATO,13.6080363,124.2977872,0,0,1,-1,13
989,2021-09-09,BATO,13.6080363,124.2977872,6,0,0,6,19
1000,2021-09-12,BATO,13.6080363,124.2977872,6,0,5,1,20
1014,2021-09-13,BATO,13.6080363,124.2977872,1,0,0,1,21
1018,2021-09-14,BATO,13.6080363,124.2977872,0,0,5,-5,16
1027,2021-09-15,BATO,13.6080363,124.2977872,0,0,1,-1,15
1042,2021-09-17,BATO,13.6080363,124.2977872,5,0,0,5,20
1051,2021-09-18,BATO,13.6080363,124.2977872,0,0,6,-6,14
1066,2021-09-20,BATO,13.6080363,124.2977872,2,0,1,1,15
1072,2021-09-21,BATO,13.6080363,124.2977872,0,0,5,-5,10
1081,2021-09-22,BATO,13.6080363,124.2977872,0,0,1,-1,9
1088,2021-09-23,BATO,13.6080363,124.2977872,1,0,0,1,10
1092,2021-09-24,BATO,13.6080363,124.2977872,4,0,0,4,14
1099,2021-09-25,BATO,13.6080363,124.2977872,1,0,2,-1,13
1111,2021-09-26,BATO,13.6080363,124.2977872,0,0,3,-3,10
1120,2021-09-27,BATO,13.6080363,124.2977872,1,0,0,1,11
1125,2021-09-28,BATO,13.6080363,124.2977872,0,0,2,-2,9
1139,2021-09-30,BATO,13.6080363,124.2977872,2,0,0,2,11
1147,2021-10-01,BATO,13.6080363,124.2977872,5,0,5,0,11
1160,2021-10-03,BATO,13.6080363,124.2977872,0,0,1,-1,10
1167,2021-10-05,BATO,13.6080363,124.2977872,0,0,1,-1,9
1174,2021-10-06,BATO,13.6080363,124.2977872,1,0,0,1,10
1183,2021-10-08,BATO,13.6080363,124.2977872,1,0,0,1,11
1194,2021-10-09,BATO,13.6080363,124.2977872,1,0,6,-5,6
1201,2021-10-10,BATO,13.6080363,124.2977872,0,0,1,-1,5
1209,2021-10-11,BATO,13.6080363,124.2977872,5,0,0,5,10
1217,2021-10-12,BATO,13.6080363,124.2977872,1,0,0,1,11
1237,2021-10-15,BATO,13.6080363,124.2977872,9,0,2,7,18
1245,2021-10-16,BATO,13.6080363,124.2977872,1,0,0,1,19
1259,2021-10-17,BATO,13.6080363,124.2977872,4,0,0,4,23
1269,2021-10-18,BATO,13.6080363,124.2977872,1,0,6,-5,18
1276,2021-10-19,BATO,13.6080363,124.2977872,1,0,0,1,19
1287,2021-10-20,BATO,13.6080363,124.2977872,1,0,0,1,20
1289,2021-10-21,BATO,13.6080363,124.2977872,0,0,1,-1,19
1296,2021-10-22,BATO,13.6080363,124.2977872,6,0,0,6,25
1312,2021-10-23,BATO,13.6080363,124.2977872,2,0,7,-5,20
1317,2021-10-24,BATO,13.6080363,124.2977872,6,0,2,4,24
1327,2021-10-25,BATO,13.6080363,124.2977872,1,0,4,-3,21
1340,2021-10-26,BATO,13.6080363,124.2977872,1,0,2,-1,20
1343,2021-10-27,BATO,13.6080363,124.2977872,0,0,1,-1,19
1353,2021-10-28,BATO,13.6080363,124.2977872,4,0,1,3,22
1370,2021-10-30,BATO,13.6080363,124.2977872,13,0,1,12,34
1373,2021-10-31,BATO,13.6080363,124.2977872,0,0,6,-6,28
1390,2021-11-01,BATO,13.6080363,124.2977872,5,0,7,-2,26
1397,2021-11-02,BATO,13.6080363,124.2977872,1,0,1,0,26
1402,2021-11-03,BATO,13.6080363,124.2977872,0,0,1,-1,25
1419,2021-11-05,BATO,13.6080363,124.2977872,1,0,0,1,26
1427,2021-11-06,BATO,13.6080363,124.2977872,1,0,16,-15,11
1432,2021-11-07,BATO,13.6080363,124.2977872,13,0,0,13,24
1445,2021-11-08,BATO,13.6080363,124.2977872,1,0,1,0,24
1447,2021-11-09,BATO,13.6080363,124.2977872,0,0,4,-4,20
1455,2021-11-10,BATO,13.6080363,124.2977872,0,0,1,-1,19
1467,2021-11-11,BATO,13.6080363,124.2977872,1,0,0,1,20
1473,2021-11-12,BATO,13.6080363,124.2977872,7,0,0,7,27
1495,2021-11-14,BATO,13.6080363,124.2977872,0,0,7,-7,20
1496,2021-11-15,BATO,13.6080363,124.2977872,1,0,7,-6,14
1510,2021-11-16,BATO,13.6080363,124.2977872,0,0,1,-1,13
1513,2021-11-17,BATO,13.6080363,124.2977872,0,0,1,-1,12
1524,2021-11-18,BATO,13.6080363,124.2977872,1,0,0,1,13
1532,2021-11-19,BATO,13.6080363,124.2977872,2,0,0,2,15
1545,2021-11-20,BATO,13.6080363,124.2977872,1,0,8,-7,8
1555,2021-11-21,BATO,13.6080363,124.2977872,1,0,0,1,9
1566,2021-11-23,BATO,13.6080363,124.2977872,0,0,1,-1,8
1579,2021-11-25,BATO,13.6080363,124.2977872,1,0,0,1,9
1594,2021-11-27,BATO,13.6080363,124.2977872,0,0,3,-3,6
1605,2021-11-29,BATO,13.6080363,124.2977872,0,0,1,-1,5
1611,2021-11-30,BATO,13.6080363,124.2977872,0,0,1,-1,4
1618,2021-12-04,BATO,13.6080363,124.2977872,0,0,1,-1,3
1639,2021-12-12,BATO,13.6080363,124.2977872,1,0,0,1,4
1648,2021-12-21,BATO,13.6080363,124.2977872,0,0,1,-1,3
1668,2022-01-07,BATO,13.6080363,124.2977872,1,0,0,1,4
1685,2022-01-12,BATO,13.6080363,124.2977872,2,0,0,2,6
1692,2022-01-13,BATO,13.6080363,124.2977872,3,0,0,3,9
1715,2022-01-16,BATO,13.6080363,124.2977872,1,0,1,0,9
1716,2022-01-17,BATO,13.6080363,124.2977872,8,0,0,8,17
1729,2022-01-18,BATO,13.6080363,124.2977872,1,0,0,1,18
1737,2022-01-19,BATO,13.6080363,124.2977872,3,0,0,3,21
1750,2022-01-21,BATO,13.6080363,124.2977872,1,0,0,1,22
1762,2022-01-22,BATO,13.6080363,124.2977872,1,0,5,-4,18
1770,2022-01-23,BATO,13.6080363,124.2977872,2,0,0,2,20
1774,2022-01-24,BATO,13.6080363,124.2977872,1,0,0,1,21
1788,2022-01-25,BATO,13.6080363,124.2977872,0,0,1,-1,20
1800,2022-01-26,BATO,13.6080363,124.2977872,5,0,8,-3,17
1806,2022-01-27,BATO,13.6080363,124.2977872,2,0,0,2,19
1814,2022-01-28,BATO,13.6080363,124.2977872,1,0,0,1,20
1817,2022-01-29,BATO,13.6080363,124.2977872,1,0,3,-2,18
1828,2022-01-30,BATO,13.6080363,124.2977872,2,0,1,1,19
1836,2022-01-31,BATO,13.6080363,124.2977872,1,0,2,-1,18
1844,2022-02-01,BATO,13.6080363,124.2977872,2,0,2,0,18
1856,2022-02-02,BATO,13.6080363,124.2977872,1,0,0,1,19
1859,2022-02-03,BATO,13.6080363,124.2977872,1,0,0,1,20
1880,2022-02-05,BATO,13.6080363,124.2977872,0,0,7,-7,13
1883,2022-02-06,BATO,13.6080363,124.2977872,0,0,1,-1,12
1900,2022-02-08,BATO,13.6080363,124.2977872,0,0,2,-2,10
1909,2022-02-09,BATO,13.6080363,124.2977872,1,0,2,-1,9
1912,2022-02-10,BATO,13.6080363,124.2977872,1,0,1,0,9
1919,2022-02-12,BATO,13.6080363,124.2977872,0,0,2,-2,7
1933,2022-02-15,BATO,13.6080363,124.2977872,0,0,1,-1,6
1952,2022-02-20,BATO,13.6080363,124.2977872,0,0,1,-1,5
1973,2022-03-02,BATO,13.6080363,124.2977872,1,0,0,1,6
1984,2022-03-07,BATO,13.6080363,124.2977872,1,0,0,1,7
1986,2022-03-12,BATO,13.6080363,124.2977872,0,0,1,-1,6
1991,2022-03-16,BATO,13.6080363,124.2977872,0,0,1,-1,5
2002,2022-04-10,BATO,13.6080363,124.2977872,1,0,0,1,6
2005,2022-04-12,BATO,13.6080363,124.2977872,0,0,1,-1,5
2012,2022-04-20,BATO,13.6080363,124.2977872,0,0,1,-1,4
2015,2022-04-24,BATO,13.6080363,124.2977872,1,0,0,1,5
2021,2022-05-03,BATO,13.6080363,124.2977872,0,0,1,-1,4
2022,2022-05-04,BATO,13.6080363,124.2977872,0,0,1,-1,3
2032,2022-05-17,BATO,13.6080363,124.2977872,0,0,1,-1,2
2063,2022-07-02,BATO,13.6080363,124.2977872,1,0,0,1,3
2078,2022-07-10,BATO,13.6080363,124.2977872,1,0,0,1,4
2080,2022-07-12,BATO,13.6080363,124.2977872,0,0,1,-1,3
2084,2022-07-13,BATO,13.6080363,124.2977872,1,0,0,1,4
2086,2022-07-14,BATO,13.6080363,124.2977872,1,0,0,1,5
2108,2022-07-20,BATO,13.6080363,124.2977872,2,0,1,1,6
2114,2022-07-21,BATO,13.6080363,124.2977872,1,0,0,1,7
2119,2022-07-23,BATO,13.6080363,124.2977872,3,0,1,2,9
2122,2022-07-24,BATO,13.6080363,124.2977872,0,0,1,-1,8
2124,2022-07-25,BATO,13.6080363,124.2977872,1,0,0,1,9
2134,2022-07-27,BATO,13.6080363,124.2977872,4,0,0,4,13
2136,2022-07-28,BATO,13.6080363,124.2977872,1,0,0,1,14
2141,2022-07-30,BATO,13.6080363,124.2977872,0,0,2,-2,12
2148,2022-07-31,BATO,13.6080363,124.2977872,1,0,1,0,12
2156,2022-08-02,BATO,13.6080363,124.2977872,0,0,3,-3,9
2161,2022-08-03,BATO,13.6080363,124.2977872,2,0,1,1,10
2165,2022-08-04,BATO,13.6080363,124.2977872,2,0,0,2,12
2169,2022-08-05,BATO,13.6080363,124.2977872,2,0,0,2,14
2175,2022-08-06,BATO,13.6080363,124.2977872,1,0,5,-4,10
2185,2022-08-10,BATO,13.6080363,124.2977872,2,0,1,1,11
2193,2022-08-12,BATO,13.6080363,124.2977872,2,0,0,2,13
2202,2022-08-13,BATO,13.6080363,124.2977872,0,0,3,-3,10
2208,2022-08-14,BATO,13.6080363,124.2977872,0,0,2,-2,8
2212,2022-08-15,BATO,13.6080363,124.2977872,0,0,1,-1,7
2213,2022-08-16,BATO,13.6080363,124.2977872,0,1,1,-2,5
2217,2022-08-17,BATO,13.6080363,124.2977872,1,0,0,1,6
2225,2022-08-20,BATO,13.6080363,124.2977872,0,0,2,-2,4
2234,2022-08-21,BATO,13.6080363,124.2977872,0,0,1,-1,3
2237,2022-08-22,BATO,13.6080363,124.2977872,0,1,1,-2,1
2250,2022-08-27,BATO,13.6080363,124.2977872,0,0,1,-1,0
2298,2022-09-23,BATO,13.6080363,124.2977872,1,0,0,1,1
2313,2022-10-02,BATO,13.6080363,124.2977872,0,0,1,-1,0
2347,2023-04-26,BATO,13.6080363,124.2977872,1,0,0,1,1
2353,2023-05-05,BATO,13.6080363,124.2977872,0,0,1,-1,0
2364,2023-05-12,BATO,13.6080363,124.2977872,1,0,0,1,1
2371,2023-05-14,BATO,13.6080363,124.2977872,2,0,0,2,3
2374,2023-05-15,BATO,13.6080363,124.2977872,1,0,0,1,4
2391,2023-05-19,BATO,13.6080363,124.2977872,2,0,0,2,6
2395,2023-05-21,BATO,13.6080363,124.2977872,1,0,1,0,6
2398,2023-05-22,BATO,13.6080363,124.2977872,0,0,1,-1,5
2404,2023-05-23,BATO,13.6080363,124.2977872,0,0,2,-2,3
2408,2023-05-24,BATO,13.6080363,124.2977872,3,0,0,3,6
2417,2023-05-26,BATO,13.6080363,124.2977872,1,0,0,1,7
2422,2023-05-27,BATO,13.6080363,124.2977872,1,0,0,1,8
2424,2023-05-28,BATO,13.6080363,124.2977872,1,0,2,-1,7
2435,2023-05-30,BATO,13.6080363,124.2977872,0,0,1,-1,6
2442,2023-05-31,BATO,13.6080363,124.2977872,2,0,0,2,8
2446,2023-06-01,BATO,13.6080363,124.2977872,0,0,3,-3,5
2459,2023-06-03,BATO,13.6080363,124.2977872,0,0,2,-2,3
2470,2023-06-06,BATO,13.6080363,124.2977872,0,0,1,-1,2
2477,2023-06-09,BATO,13.6080363,124.2977872,0,0,2,-2,0
2514,2023-07-05,BATO,13.6080363,124.2977872,1,0,0,1,1
2520,2023-07-14,BATO,13.6080363,124.2977872,0,0,1,-1,0
37,2020-08-21,SAN ANDRES,13.5989151,124.0969685,1,0,0,1,1
64,2020-09-06,SAN ANDRES,13.5989151,124.0969685,0,0,1,-1,0
98,2020-10-04,SAN ANDRES,13.5989151,124.0969685,1,0,0,1,1
114,2020-10-19,SAN ANDRES,13.5989151,124.0969685,1,0,0,1,2
121,2020-10-25,SAN ANDRES,13.5989151,124.0969685,0,0,1,-1,1
133,2020-11-01,SAN ANDRES,13.5989151,124.0969685,0,0,1,-1,0
135,2020-11-07,SAN ANDRES,13.5989151,124.0969685,1,0,0,1,1
148,2020-11-22,SAN ANDRES,13.5989151,124.0969685,0,0,1,-1,0
151,2020-11-29,SAN ANDRES,13.5989151,124.0969685,1,0,0,1,1
155,2020-12-13,SAN ANDRES,13.5989151,124.0969685,0,0,1,-1,0
165,2020-12-24,SAN ANDRES,13.5989151,124.0969685,1,0,0,1,1
167,2020-12-25,SAN ANDRES,13.5989151,124.0969685,1,0,0,1,2
169,2021-01-01,SAN ANDRES,13.5989151,124.0969685,1,0,0,1,3
174,2021-01-10,SAN ANDRES,13.5989151,124.0969685,0,0,3,-3,0
177,2021-01-13,SAN ANDRES,13.5989151,124.0969685,2,0,0,2,2
181,2021-01-15,SAN ANDRES,13.5989151,124.0969685,5,0,1,4,6
183,2021-01-16,SAN ANDRES,13.5989151,124.0969685,0,0,1,-1,5
186,2021-01-24,SAN ANDRES,13.5989151,124.0969685,2,0,3,-1,4
193,2021-01-31,SAN ANDRES,13.5989151,124.0969685,0,0,2,-2,2
196,2021-02-01,SAN ANDRES,13.5989151,124.0969685,1,0,0,1,3
201,2021-02-07,SAN ANDRES,13.5989151,124.0969685,0,0,2,-2,1
215,2021-02-18,SAN ANDRES,13.5989151,124.0969685,1,0,0,1,2
221,2021-02-21,SAN ANDRES,13.5989151,124.0969685,0,0,1,-1,1
245,2021-03-07,SAN ANDRES,13.5989151,124.0969685,0,0,1,-1,0
260,2021-03-18,SAN ANDRES,13.5989151,124.0969685,3,0,0,3,3
268,2021-03-22,SAN ANDRES,13.5989151,124.0969685,1,0,0,1,4
280,2021-03-29,SAN ANDRES,13.5989151,124.0969685,2,0,0,2,6
281,2021-03-30,SAN ANDRES,13.5989151,124.0969685,1,0,0,1,7
285,2021-04-01,SAN ANDRES,13.5989151,124.0969685,2,0,0,2,9
289,2021-04-04,SAN ANDRES,13.5989151,124.0969685,1,0,3,-2,7
295,2021-04-07,SAN ANDRES,13.5989151,124.0969685,0,1,0,-1,6
298,2021-04-08,SAN ANDRES,13.5989151,124.0969685,1,0,0,1,7
305,2021-04-11,SAN ANDRES,13.5989151,124.0969685,0,0,1,-1,6
316,2021-04-18,SAN ANDRES,13.5989151,124.0969685,0,0,4,-4,2
318,2021-04-19,SAN ANDRES,13.5989151,124.0969685,0,0,1,-1,1
328,2021-04-22,SAN ANDRES,13.5989151,124.0969685,0,0,1,-1,0
349,2021-04-29,SAN ANDRES,13.5989151,124.0969685,1,0,0,1,1
356,2021-05-02,SAN ANDRES,13.5989151,124.0969685,1,0,0,1,2
359,2021-05-04,SAN ANDRES,13.5989151,124.0969685,1,0,0,1,3
370,2021-05-07,SAN ANDRES,13.5989151,124.0969685,1,0,0,1,4
375,2021-05-08,SAN ANDRES,13.5989151,124.0969685,0,0,1,-1,3
378,2021-05-09,SAN ANDRES,13.5989151,124.0969685,1,0,0,1,4
383,2021-05-10,SAN ANDRES,13.5989151,124.0969685,0,0,1,-1,3
385,2021-05-11,SAN ANDRES,13.5989151,124.0969685,2,0,0,2,5
391,2021-05-12,SAN ANDRES,13.5989151,124.0969685,0,0,1,-1,4
397,2021-05-13,SAN ANDRES,13.5989151,124.0969685,4,0,0,4,8
405,2021-05-15,SAN ANDRES,13.5989151,124.0969685,3,0,1,2,10
408,2021-05-16,SAN ANDRES,13.5989151,124.0969685,7,1,0,6,16
411,2021-05-17,SAN ANDRES,13.5989151,124.0969685,1,0,1,0,16
419,2021-05-19,SAN ANDRES,13.5989151,124.0969685,0,0,2,-2,14
425,2021-05-20,SAN ANDRES,13.5989151,124.0969685,4,0,0,4,18
427,2021-05-21,SAN ANDRES,13.5989151,124.0969685,1,0,0,1,19
434,2021-05-22,SAN ANDRES,13.5989151,124.0969685,0,0,3,-3,16
438,2021-05-24,SAN ANDRES,13.5989151,124.0969685,0,0,10,-10,6
444,2021-05-25,SAN ANDRES,13.5989151,124.0969685,3,0,0,3,9
452,2021-05-26,SAN ANDRES,13.5989151,124.0969685,6,0,1,5,14
456,2021-05-27,SAN ANDRES,13.5989151,124.0969685,1,0,0,1,15
460,2021-05-28,SAN ANDRES,13.5989151,124.0969685,2,0,1,1,16
464,2021-05-29,SAN ANDRES,13.5989151,124.0969685,1,0,4,-3,13
471,2021-05-31,SAN ANDRES,13.5989151,124.0969685,1,0,6,-5,8
481,2021-06-02,SAN ANDRES,13.5989151,124.0969685,0,0,3,-3,5
492,2021-06-05,SAN ANDRES,13.5989151,124.0969685,0,0,1,-1,4
496,2021-06-06,SAN ANDRES,13.5989151,124.0969685,0,0,2,-2,2
503,2021-06-07,SAN ANDRES,13.5989151,124.0969685,4,0,1,3,5
510,2021-06-09,SAN ANDRES,13.5989151,124.0969685,2,0,1,1,6
519,2021-06-12,SAN ANDRES,13.5989151,124.0969685,1,0,0,1,7
527,2021-06-15,SAN ANDRES,13.5989151,124.0969685,2,0,4,-2,5
531,2021-06-16,SAN ANDRES,13.5989151,124.0969685,0,0,3,-3,2
541,2021-06-17,SAN ANDRES,13.5989151,124.0969685,2,0,0,2,4
547,2021-06-19,SAN ANDRES,13.5989151,124.0969685,2,0,0,2,6
550,2021-06-21,SAN ANDRES,13.5989151,124.0969685,3,0,1,2,8
556,2021-06-23,SAN ANDRES,13.5989151,124.0969685,0,0,1,-1,7
575,2021-06-26,SAN ANDRES,13.5989151,124.0969685,3,0,1,2,9
587,2021-06-28,SAN ANDRES,13.5989151,124.0969685,1,0,2,-1,8
591,2021-06-30,SAN ANDRES,13.5989151,124.0969685,0,0,2,-2,6
621,2021-07-05,SAN ANDRES,13.5989151,124.0969685,1,0,1,0,6
628,2021-07-07,SAN ANDRES,13.5989151,124.0969685,0,0,1,-1,5
646,2021-07-09,SAN ANDRES,13.5989151,124.0969685,1,0,0,1,6
658,2021-07-10,SAN ANDRES,13.5989151,124.0969685,2,0,0,2,8
675,2021-07-14,SAN ANDRES,13.5989151,124.0969685,0,0,1,-1,7
707,2021-07-18,SAN ANDRES,13.5989151,124.0969685,0,0,2,-2,5
715,2021-07-19,SAN ANDRES,13.5989151,124.0969685,0,0,2,-2,3
720,2021-07-20,SAN ANDRES,13.5989151,124.0969685,0,0,2,-2,1
733,2021-07-22,SAN ANDRES,13.5989151,124.0969685,1,0,0,1,2
740,2021-07-25,SAN ANDRES,13.5989151,124.0969685,3,0,0,3,5
746,2021-07-26,SAN ANDRES,13.5989151,124.0969685,3,0,0,3,8
763,2021-07-29,SAN ANDRES,13.5989151,124.0969685,1,0,0,1,9
767,2021-07-30,SAN ANDRES,13.5989151,124.0969685,1,0,0,1,10
772,2021-07-31,SAN ANDRES,13.5989151,124.0969685,1,0,1,0,10
783,2021-08-02,SAN ANDRES,13.5989151,124.0969685,0,0,1,-1,9
784,2021-08-03,SAN ANDRES,13.5989151,124.0969685,0,0,3,-3,6
793,2021-08-04,SAN ANDRES,13.5989151,124.0969685,0,0,2,-2,4
806,2021-08-07,SAN ANDRES,13.5989151,124.0969685,0,0,1,-1,3
813,2021-08-08,SAN ANDRES,13.5989151,124.0969685,0,0,1,-1,2
821,2021-08-09,SAN ANDRES,13.5989151,124.0969685,0,0,1,-1,1
838,2021-08-14,SAN ANDRES,13.5989151,124.0969685,1,0,0,1,2
859,2021-08-18,SAN ANDRES,13.5989151,124.0969685,1,0,0,1,3
869,2021-08-19,SAN ANDRES,13.5989151,124.0969685,1,0,0,1,4
894,2021-08-23,SAN ANDRES,13.5989151,124.0969685,0,0,1,-1,3
909,2021-08-27,SAN ANDRES,13.5989151,124.0969685,0,0,1,-1,2
914,2021-08-28,SAN ANDRES,13.5989151,124.0969685,0,0,1,-1,1
955,2021-09-04,SAN ANDRES,13.5989151,124.0969685,3,0,0,3,4
964,2021-09-05,SAN ANDRES,13.5989151,124.0969685,1,0,0,1,5
969,2021-09-06,SAN ANDRES,13.5989151,124.0969685,4,0,0,4,9
990,2021-09-09,SAN ANDRES,13.5989151,124.0969685,20,0,0,20,29
1004,2021-09-12,SAN ANDRES,13.5989151,124.0969685,10,0,0,10,39
1017,2021-09-13,SAN ANDRES,13.5989151,124.0969685,1,0,3,-2,37
1019,2021-09-14,SAN ANDRES,13.5989151,124.0969685,1,0,1,0,37
1031,2021-09-15,SAN ANDRES,13.5989151,124.0969685,0,0,4,-4,33
1036,2021-09-16,SAN ANDRES,13.5989151,124.0969685,7,0,0,7,40
1043,2021-09-17,SAN ANDRES,13.5989151,124.0969685,2,0,0,2,42
1057,2021-09-18,SAN ANDRES,13.5989151,124.0969685,1,0,19,-18,24
1067,2021-09-20,SAN ANDRES,13.5989151,124.0969685,2,0,0,2,26
1074,2021-09-21,SAN ANDRES,13.5989151,124.0969685,0,0,6,-6,20
1078,2021-09-22,SAN ANDRES,13.5989151,124.0969685,1,0,1,0,20
1086,2021-09-23,SAN ANDRES,13.5989151,124.0969685,3,0,1,2,22
1096,2021-09-24,SAN ANDRES,13.5989151,124.0969685,5,0,0,5,27
1104,2021-09-25,SAN ANDRES,13.5989151,124.0969685,1,0,4,-3,24
1110,2021-09-26,SAN ANDRES,13.5989151,124.0969685,4,0,2,2,26
1115,2021-09-27,SAN ANDRES,13.5989151,124.0969685,4,0,0,4,30
1128,2021-09-28,SAN ANDRES,13.5989151,124.0969685,0,0,2,-2,28
1130,2021-09-29,SAN ANDRES,13.5989151,124.0969685,0,0,1,-1,27
1137,2021-09-30,SAN ANDRES,13.5989151,124.0969685,1,0,1,0,27
1144,2021-10-01,SAN ANDRES,13.5989151,124.0969685,5,0,2,3,30
1149,2021-10-02,SAN ANDRES,13.5989151,124.0969685,2,0,0,2,32
1157,2021-10-03,SAN ANDRES,13.5989151,124.0969685,0,0,7,-7,25
1163,2021-10-04,SAN ANDRES,13.5989151,124.0969685,0,0,3,-3,22
1166,2021-10-05,SAN ANDRES,13.5989151,124.0969685,2,0,0,2,24
1171,2021-10-06,SAN ANDRES,13.5989151,124.0969685,5,0,0,5,29
1185,2021-10-08,SAN ANDRES,13.5989151,124.0969685,5,0,0,5,34
1190,2021-10-09,SAN ANDRES,13.5989151,124.0969685,11,0,5,6,40
1199,2021-10-10,SAN ANDRES,13.5989151,124.0969685,5,0,3,2,42
1213,2021-10-11,SAN ANDRES,13.5989151,124.0969685,3,0,0,3,45
1216,2021-10-12,SAN ANDRES,13.5989151,124.0969685,0,0,8,-8,37
1225,2021-10-13,SAN ANDRES,13.5989151,124.0969685,1,0,3,-2,35
1241,2021-10-15,SAN ANDRES,13.5989151,124.0969685,4,0,5,-1,34
1249,2021-10-16,SAN ANDRES,13.5989151,124.0969685,3,0,2,1,35
1253,2021-10-17,SAN ANDRES,13.5989151,124.0969685,6,0,5,1,36
1263,2021-10-18,SAN ANDRES,13.5989151,124.0969685,3,0,11,-8,28
1272,2021-10-19,SAN ANDRES,13.5989151,124.0969685,0,0,3,-3,25
1283,2021-10-20,SAN ANDRES,13.5989151,124.0969685,7,0,0,7,32
1291,2021-10-21,SAN ANDRES,13.5989151,124.0969685,1,0,0,1,33
1294,2021-10-22,SAN ANDRES,13.5989151,124.0969685,9,0,0,9,42
1311,2021-10-23,SAN ANDRES,13.5989151,124.0969685,12,0,1,11,53
1314,2021-10-24,SAN ANDRES,13.5989151,124.0969685,5,0,4,1,54
1328,2021-10-25,SAN ANDRES,13.5989151,124.0969685,14,0,1,13,67
1338,2021-10-26,SAN ANDRES,13.5989151,124.0969685,1,0,6,-5,62
1345,2021-10-27,SAN ANDRES,13.5989151,124.0969685,0,0,3,-3,59
1352,2021-10-28,SAN ANDRES,13.5989151,124.0969685,11,0,1,10,69
1364,2021-10-30,SAN ANDRES,13.5989151,124.0969685,7,0,8,-1,68
1374,2021-10-31,SAN ANDRES,13.5989151,124.0969685,13,0,9,4,72
1391,2021-11-01,SAN ANDRES,13.5989151,124.0969685,4,0,11,-7,65
1393,2021-11-02,SAN ANDRES,13.5989151,124.0969685,7,0,7,0,65
1403,2021-11-03,SAN ANDRES,13.5989151,124.0969685,0,0,13,-13,52
1414,2021-11-05,SAN ANDRES,13.5989151,124.0969685,9,0,0,9,61
1425,2021-11-06,SAN ANDRES,13.5989151,124.0969685,8,0,10,-2,59
1434,2021-11-07,SAN ANDRES,13.5989151,124.0969685,11,0,2,9,68
1441,2021-11-08,SAN ANDRES,13.5989151,124.0969685,12,0,9,3,71
1454,2021-11-09,SAN ANDRES,13.5989151,124.0969685,0,0,10,-10,61
1460,2021-11-10,SAN ANDRES,13.5989151,124.0969685,0,0,12,-12,49
1461,2021-11-11,SAN ANDRES,13.5989151,124.0969685,4,0,0,4,53
1474,2021-11-12,SAN ANDRES,13.5989151,124.0969685,3,0,0,3,56
1487,2021-11-14,SAN ANDRES,13.5989151,124.0969685,2,0,8,-6,50
1503,2021-11-15,SAN ANDRES,13.5989151,124.0969685,3,1,15,-13,37
1506,2021-11-16,SAN ANDRES,13.5989151,124.0969685,0,0,6,-6,31
1514,2021-11-17,SAN ANDRES,13.5989151,124.0969685,0,0,11,-11,20
1526,2021-11-18,SAN ANDRES,13.5989151,124.0969685,3,0,0,3,23
1528,2021-11-19,SAN ANDRES,13.5989151,124.0969685,1,0,0,1,24
1544,2021-11-20,SAN ANDRES,13.5989151,124.0969685,4,0,6,-2,22
1547,2021-11-21,SAN ANDRES,13.5989151,124.0969685,1,0,1,0,22
1557,2021-11-22,SAN ANDRES,13.5989151,124.0969685,0,0,1,-1,21
1568,2021-11-23,SAN ANDRES,13.5989151,124.0969685,0,0,2,-2,19
1573,2021-11-24,SAN ANDRES,13.5989151,124.0969685,0,0,3,-3,16
1581,2021-11-25,SAN ANDRES,13.5989151,124.0969685,2,0,0,2,18
1587,2021-11-26,SAN ANDRES,13.5989151,124.0969685,0,0,1,-1,17
1596,2021-11-27,SAN ANDRES,13.5989151,124.0969685,0,0,2,-2,15
1601,2021-11-28,SAN ANDRES,13.5989151,124.0969685,1,0,3,-2,13
1608,2021-11-29,SAN ANDRES,13.5989151,124.0969685,0,0,1,-1,12
1610,2021-11-30,SAN ANDRES,13.5989151,124.0969685,0,1,0,-1,11
1619,2021-12-04,SAN ANDRES,13.5989151,124.0969685,0,0,2,-2,9
1630,2021-12-08,SAN ANDRES,13.5989151,124.0969685,0,0,1,-1,8
1640,2021-12-14,SAN ANDRES,13.5989151,124.0969685,0,0,2,-2,6
1676,2022-01-09,SAN ANDRES,13.5989151,124.0969685,1,0,0,1,7
1680,2022-01-10,SAN ANDRES,13.5989151,124.0969685,1,0,0,1,8
1698,2022-01-14,SAN ANDRES,13.5989151,124.0969685,4,0,0,4,12
1712,2022-01-16,SAN ANDRES,13.5989151,124.0969685,1,0,0,1,13
1718,2022-01-17,SAN ANDRES,13.5989151,124.0969685,2,0,0,2,15
1725,2022-01-18,SAN ANDRES,13.5989151,124.0969685,1,0,0,1,16
1736,2022-01-19,SAN ANDRES,13.5989151,124.0969685,5,0,2,3,19
1752,2022-01-21,SAN ANDRES,13.5989151,124.0969685,3,0,0,3,22
1757,2022-01-22,SAN ANDRES,13.5989151,124.0969685,2,0,0,2,24
1768,2022-01-23,SAN ANDRES,13.5989151,124.0969685,10,0,4,6,30
1779,2022-01-24,SAN ANDRES,13.5989151,124.0969685,5,0,1,4,34
1789,2022-01-25,SAN ANDRES,13.5989151,124.0969685,0,0,1,-1,33
1799,2022-01-26,SAN ANDRES,13.5989151,124.0969685,4,0,2,2,35
1808,2022-01-27,SAN ANDRES,13.5989151,124.0969685,6,0,0,6,41
1825,2022-01-29,SAN ANDRES,13.5989151,124.0969685,7,0,5,2,43
1830,2022-01-30,SAN ANDRES,13.5989151,124.0969685,3,0,4,-1,42
1839,2022-01-31,SAN ANDRES,13.5989151,124.0969685,0,0,7,-7,35
1849,2022-02-01,SAN ANDRES,13.5989151,124.0969685,0,0,6,-6,29
1851,2022-02-02,SAN ANDRES,13.5989151,124.0969685,2,0,3,-1,28
1867,2022-02-04,SAN ANDRES,13.5989151,124.0969685,3,0,0,3,31
1872,2022-02-05,SAN ANDRES,13.5989151,124.0969685,0,0,7,-7,24
1885,2022-02-06,SAN ANDRES,13.5989151,124.0969685,2,0,4,-2,22
1902,2022-02-08,SAN ANDRES,13.5989151,124.0969685,0,0,9,-9,13
1908,2022-02-09,SAN ANDRES,13.5989151,124.0969685,1,0,1,0,13
1918,2022-02-12,SAN ANDRES,13.5989151,124.0969685,2,0,2,0,13
1927,2022-02-14,SAN ANDRES,13.5989151,124.0969685,0,0,3,-3,10
1935,2022-02-15,SAN ANDRES,13.5989151,124.0969685,0,0,1,-1,9
1936,2022-02-16,SAN ANDRES,13.5989151,124.0969685,2,0,0,2,11
1950,2022-02-19,SAN ANDRES,13.5989151,124.0969685,0,0,1,-1,10
1951,2022-02-20,SAN ANDRES,13.5989151,124.0969685,1,0,0,1,11
1955,2022-02-22,SAN ANDRES,13.5989151,124.0969685,0,0,2,-2,9
1967,2022-02-26,SAN ANDRES,13.5989151,124.0969685,0,0,2,-2,7
1975,2022-03-02,SAN ANDRES,13.5989151,124.0969685,0,0,1,-1,6
1990,2022-03-15,SAN ANDRES,13.5989151,124.0969685,1,0,0,1,7
1996,2022-03-24,SAN ANDRES,13.5989151,124.0969685,0,0,1,-1,6
2019,2022-05-01,SAN ANDRES,13.5989151,124.0969685,0,0,1,-1,5
2024,2022-05-10,SAN ANDRES,13.5989151,124.0969685,0,0,1,-1,4
2025,2022-05-11,SAN ANDRES,13.5989151,124.0969685,0,0,1,-1,3
2026,2022-05-12,SAN ANDRES,13.5989151,124.0969685,0,0,2,-2,1
2028,2022-05-14,SAN ANDRES,13.5989151,124.0969685,0,0,1,-1,0
2047,2022-06-17,SAN ANDRES,13.5989151,124.0969685,1,0,0,1,1
2048,2022-06-18,SAN ANDRES,13.5989151,124.0969685,1,0,0,1,2
2051,2022-06-19,SAN ANDRES,13.5989151,124.0969685,2,0,0,2,4
2054,2022-06-26,SAN ANDRES,13.5989151,124.0969685,0,0,1,-1,3
2058,2022-06-29,SAN ANDRES,13.5989151,124.0969685,0,0,3,-3,0
2059,2022-06-30,SAN ANDRES,13.5989151,124.0969685,2,0,0,2,2
2077,2022-07-10,SAN ANDRES,13.5989151,124.0969685,0,0,1,-1,1
2083,2022-07-13,SAN ANDRES,13.5989151,124.0969685,1,0,0,1,2
2089,2022-07-15,SAN ANDRES,13.5989151,124.0969685,1,0,0,1,3
2092,2022-07-16,SAN ANDRES,13.5989151,124.0969685,1,0,0,1,4
2096,2022-07-17,SAN ANDRES,13.5989151,124.0969685,3,0,0,3,7
2101,2022-07-18,SAN ANDRES,13.5989151,124.0969685,2,0,0,2,9
2106,2022-07-19,SAN ANDRES,13.5989151,124.0969685,1,0,0,1,10
2109,2022-07-20,SAN ANDRES,13.5989151,124.0969685,1,0,0,1,11
2112,2022-07-21,SAN ANDRES,13.5989151,124.0969685,3,0,0,3,14
2116,2022-07-22,SAN ANDRES,13.5989151,124.0969685,5,0,0,5,19
2120,2022-07-23,SAN ANDRES,13.5989151,124.0969685,0,0,1,-1,18
2126,2022-07-25,SAN ANDRES,13.5989151,124.0969685,0,0,1,-1,17
2131,2022-07-26,SAN ANDRES,13.5989151,124.0969685,0,0,3,-3,14
2135,2022-07-27,SAN ANDRES,13.5989151,124.0969685,0,0,3,-3,11
2139,2022-07-29,SAN ANDRES,13.5989151,124.0969685,1,0,0,1,12
2142,2022-07-30,SAN ANDRES,13.5989151,124.0969685,1,0,5,-4,8
2150,2022-07-31,SAN ANDRES,13.5989151,124.0969685,0,0,2,-2,6
2152,2022-08-01,SAN ANDRES,13.5989151,124.0969685,0,0,3,-3,3
2158,2022-08-03,SAN ANDRES,13.5989151,124.0969685,4,0,0,4,7
2162,2022-08-04,SAN ANDRES,13.5989151,124.0969685,10,0,0,10,17
2168,2022-08-05,SAN ANDRES,13.5989151,124.0969685,1,0,0,1,18
2179,2022-08-08,SAN ANDRES,13.5989151,124.0969685,0,0,1,-1,17
2181,2022-08-09,SAN ANDRES,13.5989151,124.0969685,0,0,1,-1,16
2189,2022-08-11,SAN ANDRES,13.5989151,124.0969685,1,0,0,1,17
2198,2022-08-13,SAN ANDRES,13.5989151,124.0969685,0,0,13,-13,4
2205,2022-08-14,SAN ANDRES,13.5989151,124.0969685,1,0,0,1,5
2209,2022-08-15,SAN ANDRES,13.5989151,124.0969685,0,0,1,-1,4
2235,2022-08-21,SAN ANDRES,13.5989151,124.0969685,0,0,1,-1,3
2238,2022-08-22,SAN ANDRES,13.5989151,124.0969685,1,0,0,1,4
2242,2022-08-23,SAN ANDRES,13.5989151,124.0969685,0,0,1,-1,3
2266,2022-09-01,SAN ANDRES,13.5989151,124.0969685,1,0,0,1,4
2274,2022-09-04,SAN ANDRES,13.5989151,124.0969685,1,0,1,0,4
2280,2022-09-07,SAN ANDRES,13.5989151,124.0969685,1,0,1,0,4
2285,2022-09-11,SAN ANDRES,13.5989151,124.0969685,0,0,1,-1,3
2289,2022-09-17,SAN ANDRES,13.5989151,124.0969685,1,0,1,0,3
2293,2022-09-19,SAN ANDRES,13.5989151,124.0969685,2,0,0,2,5
2295,2022-09-21,SAN ANDRES,13.5989151,124.0969685,1,0,0,1,6
2300,2022-09-26,SAN ANDRES,13.5989151,124.0969685,0,0,1,-1,5
2302,2022-09-27,SAN ANDRES,13.5989151,124.0969685,0,0,1,-1,4
2303,2022-09-28,SAN ANDRES,13.5989151,124.0969685,0,0,1,-1,3
2308,2022-09-30,SAN ANDRES,13.5989151,124.0969685,1,0,0,1,4
2309,2022-10-01,SAN ANDRES,13.5989151,124.0969685,0,0,1,-1,3
2315,2022-10-09,SAN ANDRES,13.5989151,124.0969685,0,0,1,-1,2
2328,2022-11-04,SAN ANDRES,13.5989151,124.0969685,0,0,1,-1,1
2344,2023-04-18,SAN ANDRES,13.5989151,124.0969685,0,0,1,-1,0
2357,2023-05-07,SAN ANDRES,13.5989151,124.0969685,1,0,0,1,1
2362,2023-05-10,SAN ANDRES,13.5989151,124.0969685,1,0,0,1,2
2365,2023-05-12,SAN ANDRES,13.5989151,124.0969685,4,0,0,4,6
2372,2023-05-14,SAN ANDRES,13.5989151,124.0969685,3,0,0,3,9
2376,2023-05-16,SAN ANDRES,13.5989151,124.0969685,0,0,1,-1,8
2383,2023-05-17,SAN ANDRES,13.5989151,124.0969685,1,0,0,1,9
2389,2023-05-19,SAN ANDRES,13.5989151,124.0969685,2,0,1,1,10
2393,2023-05-21,SAN ANDRES,13.5989151,124.0969685,4,0,4,0,10
2399,2023-05-22,SAN ANDRES,13.5989151,124.0969685,1,0,0,1,11
2405,2023-05-23,SAN ANDRES,13.5989151,124.0969685,0,0,2,-2,9
2409,2023-05-24,SAN ANDRES,13.5989151,124.0969685,2,0,0,2,11
2413,2023-05-25,SAN ANDRES,13.5989151,124.0969685,1,0,0,1,12
2418,2023-05-26,SAN ANDRES,13.5989151,124.0969685,2,0,1,1,13
2425,2023-05-28,SAN ANDRES,13.5989151,124.0969685,1,0,2,-1,12
2438,2023-05-30,SAN ANDRES,13.5989151,124.0969685,0,0,5,-5,7
2444,2023-05-31,SAN ANDRES,13.5989151,124.0969685,3,0,0,3,10
2447,2023-06-01,SAN ANDRES,13.5989151,124.0969685,0,0,1,-1,9
2452,2023-06-02,SAN ANDRES,13.5989151,124.0969685,0,0,2,-2,7
2456,2023-06-03,SAN ANDRES,13.5989151,124.0969685,1,0,0,1,8
2461,2023-06-04,SAN ANDRES,13.5989151,124.0969685,0,0,2,-2,6
2469,2023-06-06,SAN ANDRES,13.5989151,124.0969685,0,0,1,-1,5
2473,2023-06-07,SAN ANDRES,13.5989151,124.0969685,1,0,0,1,6
2478,2023-06-09,SAN ANDRES,13.5989151,124.0969685,1,0,2,-1,5
2486,2023-06-10,SAN ANDRES,13.5989151,124.0969685,0,0,1,-1,4
2497,2023-06-16,SAN ANDRES,13.5989151,124.0969685,0,0,1,-1,3
2502,2023-06-18,SAN ANDRES,13.5989151,124.0969685,0,0,1,-1,2
2512,2023-06-29,SAN ANDRES,13.5989151,124.0969685,1,0,0,1,3
2515,2023-07-05,SAN ANDRES,13.5989151,124.0969685,1,0,0,1,4
2519,2023-07-08,SAN ANDRES,13.5989151,124.0969685,0,0,1,-1,3
2526,2023-08-04,SAN ANDRES,13.5989151,124.0969685,0,0,1,-1,2
2533,2023-09-08,SAN ANDRES,13.5989151,124.0969685,0,0,1,-1,1
2539,2023-10-08,SAN ANDRES,13.5989151,124.0969685,1,0,0,1,2
2541,2023-10-16,SAN ANDRES,13.5989151,124.0969685,0,0,1,-1,1
2568,2023-12-30,SAN ANDRES,13.5989151,124.0969685,1,0,0,1,2
2572,2024-01-07,SAN ANDRES,13.5989151,124.0969685,0,0,1,-1,1
60,2020-09-05,VIGA,13.8715307,124.3087305,1,0,0,1,1
84,2020-09-22,VIGA,13.8715307,124.3087305,1,0,0,1,2
90,2020-09-27,VIGA,13.8715307,124.3087305,0,0,1,-1,1
106,2020-10-11,VIGA,13.8715307,124.3087305,0,0,1,-1,0
211,2021-02-14,VIGA,13.8715307,124.3087305,1,0,0,1,1
218,2021-02-20,VIGA,13.8715307,124.3087305,2,0,0,2,3
225,2021-02-22,VIGA,13.8715307,124.3087305,1,0,0,1,4
230,2021-02-27,VIGA,13.8715307,124.3087305,2,0,0,2,6
234,2021-02-28,VIGA,13.8715307,124.3087305,0,0,1,-1,5
235,2021-03-01,VIGA,13.8715307,124.3087305,1,0,0,1,6
240,2021-03-04,VIGA,13.8715307,124.3087305,6,0,0,6,12
246,2021-03-07,VIGA,13.8715307,124.3087305,0,0,2,-2,10
250,2021-03-08,VIGA,13.8715307,124.3087305,2,0,0,2,12
257,2021-03-14,VIGA,13.8715307,124.3087305,0,0,3,-3,9
263,2021-03-21,VIGA,13.8715307,124.3087305,0,0,7,-7,2
272,2021-03-27,VIGA,13.8715307,124.3087305,1,0,0,1,3
275,2021-03-28,VIGA,13.8715307,124.3087305,0,0,2,-2,1
286,2021-04-03,VIGA,13.8715307,124.3087305,1,0,0,1,2
301,2021-04-09,VIGA,13.8715307,124.3087305,1,0,0,1,3
307,2021-04-11,VIGA,13.8715307,124.3087305,0,0,1,-1,2
314,2021-04-18,VIGA,13.8715307,124.3087305,0,0,1,-1,1
331,2021-04-23,VIGA,13.8715307,124.3087305,0,0,1,-1,0
351,2021-04-30,VIGA,13.8715307,124.3087305,1,0,0,1,1
354,2021-05-01,VIGA,13.8715307,124.3087305,1,0,0,1,2
379,2021-05-09,VIGA,13.8715307,124.3087305,0,0,1,-1,1
387,2021-05-11,VIGA,13.8715307,124.3087305,1,0,1,0,1
414,2021-05-17,VIGA,13.8715307,124.3087305,1,0,0,1,2
422,2021-05-20,VIGA,13.8715307,124.3087305,0,0,1,-1,1
449,2021-05-26,VIGA,13.8715307,124.3087305,0,0,1,-1,0
499,2021-06-07,VIGA,13.8715307,124.3087305,2,0,0,2,2
518,2021-06-12,VIGA,13.8715307,124.3087305,1,0,0,1,3
524,2021-06-13,VIGA,13.8715307,124.3087305,0,0,2,-2,1
535,2021-06-16,VIGA,13.8715307,124.3087305,0,0,1,-1,0
568,2021-06-26,VIGA,13.8715307,124.3087305,1,0,0,1,1
584,2021-06-28,VIGA,13.8715307,124.3087305,3,0,0,3,4
600,2021-07-02,VIGA,13.8715307,124.3087305,3,0,0,3,7
610,2021-07-04,VIGA,13.8715307,124.3087305,5,0,0,5,12
615,2021-07-05,VIGA,13.8715307,124.3087305,2,0,1,1,13
627,2021-07-07,VIGA,13.8715307,124.3087305,0,0,3,-3,10
637,2021-07-08,VIGA,13.8715307,124.3087305,1,0,0,1,11
649,2021-07-09,VIGA,13.8715307,124.3087305,4,0,0,4,15
656,2021-07-10,VIGA,13.8715307,124.3087305,7,0,0,7,22
664,2021-07-11,VIGA,13.8715307,124.3087305,0,0,3,-3,19
670,2021-07-12,VIGA,13.8715307,124.3087305,5,0,0,5,24
674,2021-07-13,VIGA,13.8715307,124.3087305,0,0,5,-5,19
680,2021-07-14,VIGA,13.8715307,124.3087305,0,0,2,-2,17
688,2021-07-16,VIGA,13.8715307,124.3087305,1,0,0,1,18
699,2021-07-17,VIGA,13.8715307,124.3087305,0,0,1,-1,17
705,2021-07-18,VIGA,13.8715307,124.3087305,0,0,4,-4,13
711,2021-07-19,VIGA,13.8715307,124.3087305,0,0,7,-7,6
719,2021-07-20,VIGA,13.8715307,124.3087305,0,0,1,-1,5
724,2021-07-21,VIGA,13.8715307,124.3087305,0,0,4,-4,1
745,2021-07-25,VIGA,13.8715307,124.3087305,1,0,1,0,1
764,2021-07-29,VIGA,13.8715307,124.3087305,1,0,0,1,2
765,2021-07-30,VIGA,13.8715307,124.3087305,1,0,0,1,3
776,2021-07-31,VIGA,13.8715307,124.3087305,1,1,0,0,3
781,2021-08-02,VIGA,13.8715307,124.3087305,0,0,1,-1,2
795,2021-08-05,VIGA,13.8715307,124.3087305,1,0,0,1,3
811,2021-08-08,VIGA,13.8715307,124.3087305,0,0,1,-1,2
814,2021-08-09,VIGA,13.8715307,124.3087305,0,0,1,-1,1
827,2021-08-12,VIGA,13.8715307,124.3087305,1,0,0,1,2
839,2021-08-14,VIGA,13.8715307,124.3087305,0,0,1,-1,1
867,2021-08-19,VIGA,13.8715307,124.3087305,1,0,0,1,2
876,2021-08-21,VIGA,13.8715307,124.3087305,1,0,1,0,2
882,2021-08-22,VIGA,13.8715307,124.3087305,3,0,0,3,5
891,2021-08-23,VIGA,13.8715307,124.3087305,1,0,0,1,6
906,2021-08-26,VIGA,13.8715307,124.3087305,1,0,0,1,7
918,2021-08-28,VIGA,13.8715307,124.3087305,0,0,1,-1,6
925,2021-08-30,VIGA,13.8715307,124.3087305,4,0,1,3,9
932,2021-08-31,VIGA,13.8715307,124.3087305,2,0,3,-1,8
939,2021-09-01,VIGA,13.8715307,124.3087305,1,0,0,1,9
942,2021-09-02,VIGA,13.8715307,124.3087305,0,0,1,-1,8
946,2021-09-03,VIGA,13.8715307,124.3087305,1,0,1,0,8
976,2021-09-07,VIGA,13.8715307,124.3087305,0,0,4,-4,4
980,2021-09-08,VIGA,13.8715307,124.3087305,0,0,1,-1,3
984,2021-09-09,VIGA,13.8715307,124.3087305,1,0,2,-1,2
1007,2021-09-12,VIGA,13.8715307,124.3087305,1,0,1,0,2
1015,2021-09-13,VIGA,13.8715307,124.3087305,1,0,0,1,3
1040,2021-09-16,VIGA,13.8715307,124.3087305,3,0,0,3,6
1052,2021-09-18,VIGA,13.8715307,124.3087305,1,0,1,0,6
1062,2021-09-19,VIGA,13.8715307,124.3087305,3,0,0,3,9
1068,2021-09-20,VIGA,13.8715307,124.3087305,1,0,0,1,10
1073,2021-09-21,VIGA,13.8715307,124.3087305,0,0,1,-1,9
1080,2021-09-22,VIGA,13.8715307,124.3087305,0,0,1,-1,8
1084,2021-09-23,VIGA,13.8715307,124.3087305,9,0,0,9,17
1094,2021-09-24,VIGA,13.8715307,124.3087305,10,0,2,8,25
1102,2021-09-25,VIGA,13.8715307,124.3087305,0,0,1,-1,24
1109,2021-09-26,VIGA,13.8715307,124.3087305,6,0,0,6,30
1116,2021-09-27,VIGA,13.8715307,124.3087305,0,0,4,-4,26
1122,2021-09-28,VIGA,13.8715307,124.3087305,0,0,1,-1,25
1135,2021-09-30,VIGA,13.8715307,124.3087305,5,0,8,-3,22
1143,2021-10-01,VIGA,13.8715307,124.3087305,5,0,10,-5,17
1153,2021-10-02,VIGA,13.8715307,124.3087305,1,0,0,1,18
1155,2021-10-03,VIGA,13.8715307,124.3087305,0,0,7,-7,11
1168,2021-10-05,VIGA,13.8715307,124.3087305,2,0,0,2,13
1178,2021-10-08,VIGA,13.8715307,124.3087305,6,0,5,1,14
1193,2021-10-09,VIGA,13.8715307,124.3087305,5,0,3,2,16
1196,2021-10-10,VIGA,13.8715307,124.3087305,9,0,3,6,22
1212,2021-10-11,VIGA,13.8715307,124.3087305,1,0,0,1,23
1223,2021-10-12,VIGA,13.8715307,124.3087305,0,0,2,-2,21
1227,2021-10-13,VIGA,13.8715307,124.3087305,2,0,0,2,23
1236,2021-10-15,VIGA,13.8715307,124.3087305,2,0,5,-3,20
1243,2021-10-16,VIGA,13.8715307,124.3087305,4,0,3,1,21
1257,2021-10-17,VIGA,13.8715307,124.3087305,2,0,5,-3,18
1261,2021-10-18,VIGA,13.8715307,124.3087305,5,0,11,-6,12
1280,2021-10-20,VIGA,13.8715307,124.3087305,1,0,0,1,13
1300,2021-10-22,VIGA,13.8715307,124.3087305,2,0,0,2,15
1309,2021-10-23,VIGA,13.8715307,124.3087305,0,0,3,-3,12
1315,2021-10-24,VIGA,13.8715307,124.3087305,1,0,0,1,13
1326,2021-10-25,VIGA,13.8715307,124.3087305,2,0,2,0,13
1333,2021-10-26,VIGA,13.8715307,124.3087305,0,0,6,-6,7
1355,2021-10-28,VIGA,13.8715307,124.3087305,2,0,0,2,9
1359,2021-10-29,VIGA,13.8715307,124.3087305,0,0,2,-2,7
1367,2021-10-30,VIGA,13.8715307,124.3087305,0,0,1,-1,6
1378,2021-10-31,VIGA,13.8715307,124.3087305,0,0,1,-1,5
1389,2021-11-01,VIGA,13.8715307,124.3087305,2,0,0,2,7
1399,2021-11-02,VIGA,13.8715307,124.3087305,0,0,2,-2,5
1407,2021-11-03,VIGA,13.8715307,124.3087305,2,0,0,2,7
1410,2021-11-04,VIGA,13.8715307,124.3087305,1,0,0,1,8
1415,2021-11-05,VIGA,13.8715307,124.3087305,1,0,2,-1,7
1442,2021-11-08,VIGA,13.8715307,124.3087305,2,0,0,2,9
1451,2021-11-09,VIGA,13.8715307,124.3087305,0,0,3,-3,6
1456,2021-11-10,VIGA,13.8715307,124.3087305,0,0,2,-2,4
1466,2021-11-11,VIGA,13.8715307,124.3087305,2,0,0,2,6
1472,2021-11-12,VIGA,13.8715307,124.3087305,2,0,0,2,8
1480,2021-11-13,VIGA,13.8715307,124.3087305,1,0,0,1,9
1490,2021-11-14,VIGA,13.8715307,124.3087305,1,0,1,0,9
1509,2021-11-16,VIGA,13.8715307,124.3087305,0,0,2,-2,7
1522,2021-11-18,VIGA,13.8715307,124.3087305,3,0,0,3,10
1531,2021-11-19,VIGA,13.8715307,124.3087305,0,0,2,-2,8
1539,2021-11-20,VIGA,13.8715307,124.3087305,0,0,2,-2,6
1548,2021-11-21,VIGA,13.8715307,124.3087305,0,0,1,-1,5
1563,2021-11-22,VIGA,13.8715307,124.3087305,0,0,1,-1,4
1584,2021-11-26,VIGA,13.8715307,124.3087305,0,0,3,-3,1
1602,2021-11-28,VIGA,13.8715307,124.3087305,1,0,0,1,2
1616,2021-12-02,VIGA,13.8715307,124.3087305,1,0,0,1,3
1628,2021-12-07,VIGA,13.8715307,124.3087305,0,0,1,-1,2
1635,2021-12-10,VIGA,13.8715307,124.3087305,0,0,1,-1,1
1660,2022-01-05,VIGA,13.8715307,124.3087305,1,0,0,1,2
1665,2022-01-06,VIGA,13.8715307,124.3087305,2,0,0,2,4
1666,2022-01-07,VIGA,13.8715307,124.3087305,2,0,0,2,6
1694,2022-01-14,VIGA,13.8715307,124.3087305,0,0,1,-1,5
1701,2022-01-15,VIGA,13.8715307,124.3087305,6,0,2,4,9
1713,2022-01-16,VIGA,13.8715307,124.3087305,1,0,1,0,9
1721,2022-01-17,VIGA,13.8715307,124.3087305,3,0,0,3,12
1726,2022-01-18,VIGA,13.8715307,124.3087305,6,0,0,6,18
1733,2022-01-19,VIGA,13.8715307,124.3087305,2,0,1,1,19
1743,2022-01-20,VIGA,13.8715307,124.3087305,1,0,0,1,20
1746,2022-01-21,VIGA,13.8715307,124.3087305,1,0,0,1,21
1759,2022-01-22,VIGA,13.8715307,124.3087305,1,0,0,1,22
1769,2022-01-23,VIGA,13.8715307,124.3087305,2,0,6,-4,18
1775,2022-01-24,VIGA,13.8715307,124.3087305,1,0,1,0,18
1787,2022-01-25,VIGA,13.8715307,124.3087305,1,0,9,-8,10
1804,2022-01-27,VIGA,13.8715307,124.3087305,1,0,0,1,11
1812,2022-01-28,VIGA,13.8715307,124.3087305,3,0,0,3,14
1818,2022-01-29,VIGA,13.8715307,124.3087305,1,0,3,-2,12
1834,2022-01-30,VIGA,13.8715307,124.3087305,0,0,1,-1,11
1838,2022-01-31,VIGA,13.8715307,124.3087305,0,0,2,-2,9
1846,2022-02-01,VIGA,13.8715307,124.3087305,0,0,2,-2,7
1853,2022-02-02,VIGA,13.8715307,124.3087305,3,0,0,3,10
1861,2022-02-03,VIGA,13.8715307,124.3087305,0,0,1,-1,9
1869,2022-02-04,VIGA,13.8715307,124.3087305,1,0,1,0,9
1874,2022-02-05,VIGA,13.8715307,124.3087305,0,0,1,-1,8
1889,2022-02-06,VIGA,13.8715307,124.3087305,1,0,2,-1,7
1891,2022-02-07,VIGA,13.8715307,124.3087305,0,0,1,-1,6
1914,2022-02-11,VIGA,13.8715307,124.3087305,0,0,2,-2,4
1922,2022-02-12,VIGA,13.8715307,124.3087305,0,0,1,-1,3
1942,2022-02-16,VIGA,13.8715307,124.3087305,0,0,1,-1,2
1964,2022-02-25,VIGA,13.8715307,124.3087305,1,0,0,1,3
2004,2022-04-12,VIGA,13.8715307,124.3087305,1,0,0,1,4
2006,2022-04-14,VIGA,13.8715307,124.3087305,1,0,0,1,5
2013,2022-04-21,VIGA,13.8715307,124.3087305,0,0,1,-1,4
2014,2022-04-23,VIGA,13.8715307,124.3087305,0,0,1,-1,3
2018,2022-05-01,VIGA,13.8715307,124.3087305,1,0,0,1,4
2020,2022-05-02,VIGA,13.8715307,124.3087305,0,0,1,-1,3
2023,2022-05-10,VIGA,13.8715307,124.3087305,0,0,1,-1,2
2031,2022-05-16,VIGA,13.8715307,124.3087305,0,0,1,-1,1
2040,2022-06-01,VIGA,13.8715307,124.3087305,1,0,0,1,2
2045,2022-06-10,VIGA,13.8715307,124.3087305,0,0,1,-1,1
2065,2022-07-03,VIGA,13.8715307,124.3087305,1,0,0,1,2
2074,2022-07-09,VIGA,13.8715307,124.3087305,1,0,0,1,3
2082,2022-07-13,VIGA,13.8715307,124.3087305,0,0,1,-1,2
2105,2022-07-19,VIGA,13.8715307,124.3087305,0,0,1,-1,1
2186,2022-08-10,VIGA,13.8715307,124.3087305,1,0,0,1,2
2227,2022-08-20,VIGA,13.8715307,124.3087305,1,0,1,0,2
2265,2022-09-01,VIGA,13.8715307,124.3087305,0,1,1,-2,0
2316,2022-10-10,VIGA,13.8715307,124.3087305,1,0,0,1,1
2322,2022-10-16,VIGA,13.8715307,124.3087305,0,0,1,-1,0
2382,2023-05-17,VIGA,13.8715307,124.3087305,1,0,0,1,1
2384,2023-05-18,VIGA,13.8715307,124.3087305,1,0,0,1,2
2414,2023-05-26,VIGA,13.8715307,124.3087305,0,0,2,-2,0
2440,2023-05-31,VIGA,13.8715307,124.3087305,1,0,0,1,1
2483,2023-06-09,VIGA,13.8715307,124.3087305,0,0,1,-1,0
2511,2023-06-28,VIGA,13.8715307,124.3087305,1,0,0,1,1
2517,2023-07-07,VIGA,13.8715307,124.3087305,0,0,1,-1,0
2567,2023-12-30,VIGA,13.8715307,124.3087305,1,0,0,1,1
2573,2024-01-07,VIGA,13.8715307,124.3087305,0,0,1,-1,0
